,id,name,all_time_quantity_sold,price,store_id,discount,discount_rate,images,inventory_status,list_price,original_price,rating_average,review_count
0,270183212,Kỹ Năng Viết Cho Người Hành Nghề Luật,41,275000,10577,15000,5,https://salt.tikicdn.com/ts/product/d7/c4/c3/8642659cee2a2b430ec6448ee97a88fe.jpg,1,290000,290000,5.0,4
1,249009518,"Sổ kế hoạch planner 18 tháng 2023-2024 SDstationery DREAM CRAFTER 48 trang 16,5x20,5cm",107,19500,122,19500,50,https://salt.tikicdn.com/ts/product/55/cb/1b/ca6df9ada35fb8a9c57e5168542b0019.jpg,1,39000,39000,5.0,6
2,7823190,Kiến Trúc Thú Vị,360,63800,40395,21200,25,https://salt.tikicdn.com/ts/product/4e/76/e2/64a6f42733e32207232b335bf83ca508.png,1,85000,85000,4.5,13
3,53434797,Sách Tài Chính Cá Nhân Cho Người Việt Nam - Tặng Khóa học Online về Tài chính,13635,200000,108492,0,0,https://salt.tikicdn.com/ts/product/29/f0/ad/2d35f5288ea643e3768c8f3361cafa5a.jpg,1,200000,200000,4.7,1787
4,274275280,So Sánh Luật Đất Đai  năm 2013 và năm 2024,7,260000,10577,165000,39,https://salt.tikicdn.com/ts/product/df/02/66/28731c1397b786243daa2cb3f9a2d145.jpeg,1,425000,425000,0.0,0
5,74021317,Cây Cam Ngọt Của Tôi,72644,75400,40395,32600,30,https://salt.tikicdn.com/ts/product/b2/73/c4/31089a3cb10e70092d898fecaa2da18d.png,1,108000,108000,5.0,13284
6,188940817,Vị Thần Của Những Quyết Định,9942,52930,40395,26070,33,https://salt.tikicdn.com/ts/product/f4/29/80/ccc84cef32909779f47336224ab5db93.png,1,79000,79000,4.8,1160
7,189643105,Không Phải Sói Nhưng Cũng Đừng Là Cừu -Tặng kèm bookmark 2 mặt,13094,86900,40395,41100,32,https://salt.tikicdn.com/ts/product/c1/ac/74/a96cad7ead5fe6ec3ff205e167855534.png,1,128000,128000,4.8,1425
8,26114399,"Nóng Giận Là Bản Năng , Tĩnh Lặng Là Bản Lĩnh",74405,64800,40395,24200,27,https://salt.tikicdn.com/ts/product/e1/e3/27/cb510edfda5f7a2bb49999cf760bf111.jpg,1,89000,89000,4.8,7204
9,109017985,"Thiên Tài Bên Trái, Kẻ Điên Bên Phải (Tái Bản)",25879,116000,40395,63000,35,https://salt.tikicdn.com/ts/product/52/7d/95/6ecbef0767ee8bda715b2fb834fe9005.jpg,1,179000,179000,4.8,5425
10,174588795,Ngụy Võ Đế Tào Tháo (Tái Bản 2022),83,324000,40395,91000,22,https://salt.tikicdn.com/ts/product/9f/b0/6d/fc3e3898b88eb0f05d1c1bc047857847.png,1,415000,415000,5.0,17
11,50215817,Combo Cẩm Nang Bé Gái Tuổi Dậy Thì - Quyển 1 Và 2 (Tái Bản 2019) (Bộ 2 Quyển),235,260500,26242,0,0,https://salt.tikicdn.com/ts/product/77/f2/63/d284bf77ee91d9ba8018ac985b32a09c.jpg,1,260500,260500,4.7,27
12,52785564,Dịch Hạch (Nobel Văn Chương 1957),3565,96800,40395,32200,25,https://salt.tikicdn.com/ts/product/66/a3/17/0b51ca0db5a98c5b2753c7426738d979.png,1,129000,129000,4.6,588
13,200617436,Từ Điển Việt - Anh (Khoảng 75.000 mục từ ),36,57800,40395,27200,32,https://salt.tikicdn.com/ts/product/41/38/99/5d43323c19f85f25868a0d209c128b97.jpg,1,85000,85000,4.7,3
14,247667661,Các Nghị Quyết Của Hội Đồng Thẩm Phán Toà Án Nhân Dân Tối Cao Về Hình Sự - Tố Tụng Hình Sự - Dân Sự - Tố Tụng Dân Sự -Hành Chính,3,290000,10577,105000,27,https://salt.tikicdn.com/ts/product/7b/8b/7d/a096e489ff2b2facb7a417b6f1dd112e.jpg,1,395000,395000,0.0,0
15,174301838,BỘ BOOKMARK 1% TINH HOA,3139,49000,7269,0,0,https://salt.tikicdn.com/ts/product/ed/47/41/11907cc08f51371bc8c5519db62c900c.png,1,49000,49000,4.8,18
16,52789367,Nhà Giả Kim (Tái Bản 2020),33896,55200,40395,23800,30,https://salt.tikicdn.com/ts/product/ee/09/41/1424314a1a2c4faed0843a3d21201a92.png,1,79000,79000,5.0,5875
17,69764541,Tâm Lý Học Hành Vi (Tặng Kèm 1 Bookmark ),16318,70500,40395,27500,28,https://salt.tikicdn.com/ts/product/0c/19/4a/6c8406efbf80da52d520dfd72181b99a.jpg,1,98000,98000,5.0,2781
18,174444163,"Dear, Darling",6130,59700,40395,28300,32,https://salt.tikicdn.com/ts/product/a8/1d/26/213a97add48ef8191b0f6415bb5ae615.jpg,1,88000,88000,4.8,888
19,73207240,Xa Ngoài Kia Nơi Loài Tôm Hát - Where The Crawdads Sing,4217,132000,40395,33000,20,https://salt.tikicdn.com/ts/product/e6/87/03/ef5b33b2d0a1e5192f3d88bf52c15408.png,1,165000,165000,5.0,646
20,15245928,Băng keo 2 mặt chịu nhiệt dán linh kiện điện tử 3M khổ 10mm x 50m 9448A-10,35,123000,8537,12000,9,https://salt.tikicdn.com/ts/product/9a/8e/b2/e122f3b2087946c78229f1f4f2043f42.jpg,1,135000,135000,4.8,6
21,193099631,Đại Gia Gatsby,775,64400,40395,21600,25,https://salt.tikicdn.com/ts/product/1b/65/bd/5236fe1e51dd63aae463471ab1c86816.jpg,1,86000,86000,5.0,79
22,274163327,Bộ Thẻ Rèn Trí Sáng Suốt mới (Nâng cấp thay thế cho bộ Thẻ Chánh Kiến) - Sản phẩm tâm huyết thầy Trần Việt Quân,1,245000,338765,55000,18,https://salt.tikicdn.com/ts/product/90/76/1f/11e1f430a0d9c199c714a8deab54c49a.jpg,1,300000,300000,0.0,0
23,7718737,Nghệ Thuật Tư Duy Rành Mạch (Tái Bản),11353,88300,40395,29700,25,https://salt.tikicdn.com/ts/product/ea/26/6a/a3ddb60453d65d3d7dd6e564e519299f.jpg,1,118000,118000,4.8,1012
24,271319877,Bấm Huyệt Bàn Chân - Tái Bản,37,61300,40395,28700,32,https://salt.tikicdn.com/ts/product/73/19/56/c9438eba33bb7ae2ef3aff8558541c6b.jpg,1,90000,90000,1.0,1
25,121635154,Điều Đẹp Nhất Có Khi Là Buông Tay (Tặng Kèm Bookmark),5467,48900,40395,23100,32,https://salt.tikicdn.com/ts/product/2e/39/a3/bd4aaad8c4dca1ff75617e5d38ff8b21.jpg,1,72000,72000,4.8,623
26,147920903,Một Thoáng Ta Rực Rỡ Ở Nhân Gian,14098,101000,40395,34000,25,https://salt.tikicdn.com/ts/product/6c/e2/bf/5be96097ea4b7e58f1d4e838cb5063e4.jpg,1,135000,135000,4.8,1988
27,3954355,Yêu Những Điều Không Hoàn Hảo,39949,83400,40395,55600,40,https://salt.tikicdn.com/ts/product/16/2f/ab/85cf6c3b7cc2b66723ddc1d15278a784.png,1,139000,139000,5.0,3926
28,73787185,Những Tù Nhân Của Địa Lý,22426,147000,40395,63000,30,https://salt.tikicdn.com/ts/product/8d/96/9e/c0c1f23db756d50b1944dff9c3988753.jpg,1,210000,210000,4.8,4078
29,117254517,Đại Dương Đen - Những Câu Chuyện Từ Thế Giới Của Trầm Cảm,13044,168000,40395,72000,30,https://salt.tikicdn.com/ts/product/91/82/f6/1111aef015b032d353767ea207b75c30.jpg,1,240000,240000,5.0,2364
30,42230121,Sách Hiểu Về Trái Tim (Tái Bản 2019) - Minh Niệm,35503,129000,40395,29000,18,https://salt.tikicdn.com/ts/product/57/ab/ff/4f7ce7cc3e08cfd8908a5efc1e8f82b4.jpg,1,158000,158000,4.8,3655
31,46240929,Rèn Luyện Tư Duy Phản Biện,30543,64300,40395,34700,35,https://salt.tikicdn.com/ts/product/c3/51/d8/908cd5310a98a19d52d2be9146769fa3.png,1,99000,99000,4.8,4778
32,117238177,Thư Viện Nửa Đêm,10058,90000,40395,60000,40,https://salt.tikicdn.com/ts/product/0e/ac/86/b219b344daa3e0ff49a8bc6887f900d6.png,1,150000,150000,5.0,1869
33,143217512,Điềm Tĩnh Và Nóng Giận,10855,62300,40395,33700,35,https://salt.tikicdn.com/ts/product/fa/5d/f3/6276723d9fad2743db7591aeafb93f0a.jpg,1,96000,96000,4.8,1125
34,72882553,Kỷ Luật Tự Giác (Tặng Kèm Bookmark ),11649,52080,40395,31920,38,https://salt.tikicdn.com/ts/product/3c/42/f4/41509062edf69a9b4d87787e33a0ce22.jpg,1,84000,84000,4.8,2102
35,195801653,Chú Thuật Hồi Chiến - Tập 6,3168,26900,40395,3100,10,https://salt.tikicdn.com/ts/product/fe/24/90/6583692317621758a7645b50aaf42fb6.jpg,1,30000,30000,5.0,794
36,157432544,Giải Thích Ngữ Pháp Tiếng Anh (Với Bài Tập Và Đáp Án) (Tái Bản),10352,143000,40395,77000,35,https://salt.tikicdn.com/ts/product/da/3f/bb/a81df6a04efd34c4d51c42816b222f08.jpg,1,220000,220000,5.0,1459
37,197719874,Suy Nghĩ Thống Kê Trong Đời Thường,1555,114000,40395,46000,29,https://salt.tikicdn.com/ts/product/55/5e/a6/dd0a224ea101cbefb2770bb9c4f5a30d.jpg,1,160000,160000,5.0,169
38,121635152,Không Ai Có Thể Làm Bạn Tổn Thương Trừ Khi Bạn Cho Phép (Tặng Kèm 1 Bộ Bookmark Gồm 4 Cái),11966,77300,40395,41700,35,https://salt.tikicdn.com/ts/product/48/cf/b6/591dc6b51337aca15183552706b57087.jpg,1,119000,119000,5.0,1752
39,190861557,Yêu Những Ngày Nắng Chẳng Ghét Những Ngày Mưa,5352,80520,40395,51480,39,https://salt.tikicdn.com/ts/product/58/c0/b1/1705ea0d4c25cbf08b934272b0bda6c0.png,1,132000,132000,5.0,894
40,196515658,Blue Period - Tập 04,916,36000,40395,12000,25,https://salt.tikicdn.com/ts/product/0b/47/a6/c0c6b79d8894219acaa53815f9ea9a22.jpg,1,48000,48000,5.0,167
41,193151000,"Trend Following – Cách thức để kiếm được VẬN MAY LỚN và GIÀU CÓ trong các thị trường BÒ, GẤU và các sự kiện THIÊN NGA ĐEN",953,599000,7269,0,0,https://salt.tikicdn.com/ts/product/3b/0f/36/3ef1ef1cbec5724c27e8815cbb68786b.png,1,599000,599000,4.7,129
42,194959173,Semantic Error – Lỗi Logic (Tập 2),2461,155000,40395,104000,40,https://salt.tikicdn.com/ts/product/62/4b/23/35b3d23518e503fca0bfbbe0cb99eb54.png,1,259000,259000,4.8,644
43,72459686,How Psychology Works - Hiểu Hết Về Tâm Lý Học,16014,210000,40395,90000,30,https://salt.tikicdn.com/ts/product/ba/e0/f8/1467e532030ac2e305b7402c6a18fa0f.jpg,1,300000,300000,4.8,3389
44,195969664,Tokyo Revengers - Tập 4,937,74750,40395,40250,35,https://salt.tikicdn.com/ts/product/e4/49/ed/f53036fa665f9d3aa239c263337db1c7.jpg,1,115000,115000,5.0,202
45,8885999,Totto - Chan Bên Cửa Sổ (Tái Bản),21855,68500,40395,29500,30,https://salt.tikicdn.com/ts/product/7f/21/78/a9cb623c790d524f60846a7d1b1c2a54.jpg,1,98000,98000,5.0,2078
46,68585576,"Càng Kỷ Luật, Càng Tự Do",21355,76200,40395,32800,30,https://salt.tikicdn.com/ts/product/e5/9e/3e/405f647bc0e55f372e6926e20b3e6504.png,1,109000,109000,4.8,3555
47,106863963,Tâm Lý Học - Phác Họa Chân Dung Kẻ Phạm Tội,22276,94200,40395,50800,35,https://salt.tikicdn.com/ts/product/50/37/95/96a6966d0b598f5b2adc22cce8aef865.jpg,1,145000,145000,4.8,6124
48,145288029,Xứ Cát,7519,174000,40395,75000,30,https://salt.tikicdn.com/ts/product/ec/49/26/269fc4c4dceb8ed58f048011b0aaf5a4.png,1,249000,249000,4.7,1283
49,111285062,Đắc Nhân Tâm (Bìa Mềm)(Tái Bản),10768,53200,40395,32800,38,https://salt.tikicdn.com/ts/product/73/ac/e1/41f2139e7511de8b97a2a500032c46c9.jpg,1,86000,86000,4.8,1062
50,85763211,Hãy Khiến Tương Lai Biết Ơn Vì Hiện Tại Bạn Đã Cố Gắng Hết Mình (Tặng Kèm: 01 Bookmark),12321,64400,40395,34600,35,https://salt.tikicdn.com/ts/product/52/76/da/7fd7b3c6471bf5aba7be50d39dfffe9a.jpg,1,99000,99000,5.0,2477
51,194960721,Blue Period - Tập 03,1417,36000,40395,12000,25,https://salt.tikicdn.com/ts/product/f4/bf/cd/1f6a6e54c2951ba8b1411f2dc4360e51.png,1,48000,48000,5.0,256
52,3304875,Điều Kỳ Diệu Của Tiệm Tạp Hóa NAMIYA (Tái Bản),32538,63000,40395,42000,40,https://salt.tikicdn.com/ts/product/5f/87/cb/d6660f4ff53fe0889b38a817cd62e7b0.png,1,105000,105000,5.0,4665
53,10095276,Ikigai - Bí Mật Sống Trường Thọ Và Hạnh Phúc Của Người Nhật,8793,70100,40395,19900,22,https://salt.tikicdn.com/ts/product/e9/f6/23/cee87c1cde913c9cf27757b09c88a6e5.png,1,90000,90000,4.8,705
54,113530805,Tuổi Trẻ Đáng Giá Bao Nhiêu (Tái Bản),10054,67400,40395,22600,25,https://salt.tikicdn.com/ts/product/1c/23/9d/60897f8c95577344740d489720ca900b.jpg,1,90000,90000,4.8,1489
55,270183212,Kỹ Năng Viết Cho Người Hành Nghề Luật,41,275000,10577,15000,5,https://salt.tikicdn.com/ts/product/d7/c4/c3/8642659cee2a2b430ec6448ee97a88fe.jpg,1,290000,290000,5.0,4
56,249009518,"Sổ kế hoạch planner 18 tháng 2023-2024 SDstationery DREAM CRAFTER 48 trang 16,5x20,5cm",107,19500,122,19500,50,https://salt.tikicdn.com/ts/product/55/cb/1b/ca6df9ada35fb8a9c57e5168542b0019.jpg,1,39000,39000,5.0,6
57,7823190,Kiến Trúc Thú Vị,360,63800,40395,21200,25,https://salt.tikicdn.com/ts/product/4e/76/e2/64a6f42733e32207232b335bf83ca508.png,1,85000,85000,4.5,13
58,53434797,Sách Tài Chính Cá Nhân Cho Người Việt Nam - Tặng Khóa học Online về Tài chính,13635,200000,108492,0,0,https://salt.tikicdn.com/ts/product/29/f0/ad/2d35f5288ea643e3768c8f3361cafa5a.jpg,1,200000,200000,4.7,1787
59,274275280,So Sánh Luật Đất Đai  năm 2013 và năm 2024,7,260000,10577,165000,39,https://salt.tikicdn.com/ts/product/df/02/66/28731c1397b786243daa2cb3f9a2d145.jpeg,1,425000,425000,0.0,0
60,168283405,Chiến Tranh Tiền Tệ - Phần 1 - Ai Thực Sự Là Người Giàu Nhất Thế Giới ( Tái Bản 2022),6563,115000,40395,50000,30,https://salt.tikicdn.com/ts/product/39/03/01/b4a8bd3e0d57d77693d0a132e763593e.jpg,1,165000,165000,5.0,751
61,161008715,Power Vs Force - Trường Năng Lượng Và Những Nhân Tố Quyết Định Hành Vi Của Con Người (Tái Bản),6040,122000,40395,57000,32,https://salt.tikicdn.com/ts/product/04/31/31/2f02dca0ba3ed200b6d1f22606842fac.jpg,1,179000,179000,5.0,537
62,54614797,"Có Một Ngày, Bố Mẹ Sẽ Già Đi",12673,62300,40395,33700,35,https://salt.tikicdn.com/ts/product/a7/cf/fe/673ac209192c0a49ed844f58ebbdb708.png,1,96000,96000,4.8,2412
63,3639597,Bước Chậm Lại Giữa Thế Gian Vội Vã (Tái Bản),47836,59300,40395,25700,30,https://salt.tikicdn.com/ts/product/63/a2/b5/01a20949ec17b9b6466901918285ed5f.png,1,85000,85000,4.8,3965
64,4780917,Người Đua Diều (Tái Bản 2018),21080,90200,40395,38800,30,https://salt.tikicdn.com/ts/product/2c/af/62/c7f70bf0b15e19de63682a9433b8140b.png,1,129000,129000,4.8,2587
65,174588795,Ngụy Võ Đế Tào Tháo (Tái Bản 2022),83,324000,40395,91000,22,https://salt.tikicdn.com/ts/product/9f/b0/6d/fc3e3898b88eb0f05d1c1bc047857847.png,1,415000,415000,5.0,17
66,50215817,Combo Cẩm Nang Bé Gái Tuổi Dậy Thì - Quyển 1 Và 2 (Tái Bản 2019) (Bộ 2 Quyển),235,260500,26242,0,0,https://salt.tikicdn.com/ts/product/77/f2/63/d284bf77ee91d9ba8018ac985b32a09c.jpg,1,260500,260500,4.7,27
67,52785564,Dịch Hạch (Nobel Văn Chương 1957),3565,83850,40395,45150,35,https://salt.tikicdn.com/ts/product/66/a3/17/0b51ca0db5a98c5b2753c7426738d979.png,1,129000,129000,4.6,588
68,200617436,Từ Điển Việt - Anh (Khoảng 75.000 mục từ ),36,57800,40395,27200,32,https://salt.tikicdn.com/ts/product/41/38/99/5d43323c19f85f25868a0d209c128b97.jpg,1,85000,85000,4.7,3
69,247667661,Các Nghị Quyết Của Hội Đồng Thẩm Phán Toà Án Nhân Dân Tối Cao Về Hình Sự - Tố Tụng Hình Sự - Dân Sự - Tố Tụng Dân Sự -Hành Chính,3,290000,10577,105000,27,https://salt.tikicdn.com/ts/product/7b/8b/7d/a096e489ff2b2facb7a417b6f1dd112e.jpg,1,395000,395000,0.0,0
70,17336364,Phía Sau Nghi Can X (Tái Bản 2019),18875,77400,40395,51600,40,https://salt.tikicdn.com/ts/product/8e/24/65/9ac224e8becb309c244f62f0922c333a.jpg,1,129000,129000,4.8,3489
71,71345381,Sách Thay Đổi Cuộc Sống Với Nhân Số Học - Lê Đỗ Quỳnh Hương,31687,177000,40395,71000,29,https://salt.tikicdn.com/ts/product/8c/52/24/0cdce8c01252f9798255b95790219f73.jpg,1,248000,248000,4.8,5249
72,197344455,Ikigami - The Ultimate Limit - Tuyển Tập Những Câu Chuyện Lay Động Lòng Người - Tập 9,611,31600,40395,13400,30,https://salt.tikicdn.com/ts/product/06/5a/ba/666c8e3d4bb104430dde2db9351f18c0.jpg,1,45000,45000,5.0,84
73,92859698,Tâm Lý Học Biểu Cảm,7869,70500,40395,27500,28,https://salt.tikicdn.com/ts/product/41/d6/6b/854b921bdf0ee7598613202a6a26ac81.jpg,1,98000,98000,5.0,1491
74,10005245,Đàn Ông Sao Hỏa Đàn Bà Sao Kim,52097,127000,40395,61000,32,https://salt.tikicdn.com/ts/product/29/43/01/bd04f0946bed192d8cf7875167b0e3bd.jpg,1,188000,188000,4.8,4140
75,15245928,Băng keo 2 mặt chịu nhiệt dán linh kiện điện tử 3M khổ 10mm x 50m 9448A-10,35,135000,8537,0,0,https://salt.tikicdn.com/ts/product/9a/8e/b2/e122f3b2087946c78229f1f4f2043f42.jpg,1,135000,135000,4.8,6
76,193099631,Đại Gia Gatsby,775,64400,40395,21600,25,https://salt.tikicdn.com/ts/product/1b/65/bd/5236fe1e51dd63aae463471ab1c86816.jpg,1,86000,86000,5.0,79
77,274163327,Bộ Thẻ Rèn Trí Sáng Suốt mới (Nâng cấp thay thế cho bộ Thẻ Chánh Kiến) - Sản phẩm tâm huyết thầy Trần Việt Quân,1,245000,338765,55000,18,https://salt.tikicdn.com/ts/product/90/76/1f/11e1f430a0d9c199c714a8deab54c49a.jpg,1,300000,300000,0.0,0
78,7718737,Nghệ Thuật Tư Duy Rành Mạch (Tái Bản),11353,88300,40395,29700,25,https://salt.tikicdn.com/ts/product/ea/26/6a/a3ddb60453d65d3d7dd6e564e519299f.jpg,1,118000,118000,4.8,1012
79,271319877,Bấm Huyệt Bàn Chân - Tái Bản,37,61300,40395,28700,32,https://salt.tikicdn.com/ts/product/73/19/56/c9438eba33bb7ae2ef3aff8558541c6b.jpg,1,90000,90000,1.0,1
80,8885995,Sự Im Lặng Của Bầy Cừu (Tái Bản),17810,78200,40395,36800,32,https://salt.tikicdn.com/ts/product/d9/90/dd/6b11e001c263aed8f07964450e45e199.png,1,115000,115000,4.8,2702
81,184466860,Hành Tinh Của Một Kẻ Nghĩ Nhiều,16804,56000,40395,30000,35,https://salt.tikicdn.com/ts/product/90/43/a4/4c900bba6e328fb83d39330b27ea293a.jpg,1,86000,86000,4.8,1752
82,52788072,Chiến Binh Cầu Vồng (Tái Bản 2020),21351,65400,40395,43600,40,https://salt.tikicdn.com/ts/product/59/ec/4f/b15b0f67dbc388e74de5759201f9f725.png,1,109000,109000,4.8,3379
83,161008717,Kiếp Nào Ta Cũng Tìm Thấy Nhau: Câu Chuyện Về Những Linh Hồn Tri Kỷ Vĩnh Viễn Không Chia Lìa (Tái Bản),6431,67200,40395,31800,32,https://salt.tikicdn.com/ts/product/96/cc/2d/a53a2beff5944a6326ae28ad25b802b5.png,1,99000,99000,5.0,716
84,114937969,Rừng Nauy (Tái Bản),6325,90000,40395,60000,40,https://salt.tikicdn.com/ts/product/e1/7e/b2/3ecb80342561823c9052b8ce88a2aa5c.png,1,150000,150000,5.0,1074
85,78598381,Tâm Lý Học Tính Cách (Tặng Kèm: 1 Bookmark),6979,74100,40395,34900,32,https://salt.tikicdn.com/ts/product/a3/28/20/afb06be5525494d91e672bd4db6f4767.jpg,1,109000,109000,5.0,1370
86,161310103,Từ Vựng IELTS 8.0 - Từ Vựng Đắt Để Đạt Điểm Cao 4 Kỹ Năng,3844,91700,40395,43300,32,https://salt.tikicdn.com/media/catalog/producttmp/7a/4c/89/a28e0136d183b09c71ed6a33f8b223ba.jpg,1,135000,135000,5.0,505
87,15267827,Hoàng Tử Bé (Tái Bản 2019),25476,52400,40395,22600,30,https://salt.tikicdn.com/ts/product/22/e9/24/252e578ddec1722c75266107d3955223.jpg,1,75000,75000,5.0,3431
88,196932307,Here U Are – Tập 3,1181,90000,40395,29000,24,https://salt.tikicdn.com/ts/product/00/d3/8d/ea03d5c7f9a408870cad270b0d962cf0.JPG,1,119000,119000,4.8,291
89,104612965,FLASHCARD SachID Moon,6815,10000,162100,0,0,https://salt.tikicdn.com/ts/product/7e/7b/3f/d8227246e7128960add5d774b5e2e80b.jpg,1,10000,10000,4.8,84
90,49747007,Hai Mặt Của Gia Đình,12760,60759,40395,37241,38,https://salt.tikicdn.com/ts/product/ac/9c/7e/ac3dd0ab31d76594f69161814616fc8d.jpg,1,98000,98000,4.8,1877
91,54266567,Sách Nghĩ Giàu Và Làm Giàu (Bìa Mềm),13348,73300,40395,36700,33,https://salt.tikicdn.com/ts/product/62/b7/62/3b3a507acef199e5149f32610ad1e8d3.png,1,110000,110000,5.0,1781
92,76388962,"Chúng Ta Rồi Sẽ Hạnh Phúc, Theo Những Cách Khác Nhau [Tặng Kèm: 01 Bookmark]",9891,55900,40395,30100,35,https://salt.tikicdn.com/ts/product/66/d0/fa/dd2b50470b5b116b5ccdf4a0efdcbd01.jpg,1,86000,86000,4.8,1838
93,187338036,Chiến Tranh Tiền Tệ - Tập 4,1980,117000,40395,68000,37,https://salt.tikicdn.com/ts/product/09/1f/4d/937d1d1b96ba5e27d44b5fb88f91f2b7.jpg,1,185000,185000,5.0,245
94,53720978,"Trong Cái Không Có Gì Không ? (Thiền Sư Thích Nhất Hạnh Trả Lời Cho Trẻ Em Những Thắc Mắc Về Ý Nghĩa Cuộc Sống, Về Cái Chết, Về Gia Đình, Bạn Bè Và Nhiều Câu Hỏi Khác)",4352,125000,40395,35000,22,https://salt.tikicdn.com/ts/product/47/d1/6b/45e2d3d4f4ce573116f5e88279e12ed9.png,1,160000,160000,5.0,465
95,168373800,Sách - Thao túng tâm lý - 1980BOOKS,1395,105000,172070,64000,38,https://salt.tikicdn.com/ts/product/f0/a3/77/d1e9f0745ee17a54f5c47cc279bb35e8.jpg,1,169000,169000,4.7,150
96,57325187,Sách Người Giàu Có Nhất Thành Babylon (Tái Bản 2020),16882,64200,40395,33800,34,https://salt.tikicdn.com/media/catalog/producttmp/5d/ac/3b/ae527a4e3abf97b9f58f1a788b1b32f0.jpg,1,98000,98000,5.0,2466
97,171556602,2030: Những Xu Hướng Lớn Sẽ Định Hình Thế Giới Tương Lai (Tái Bản Lần 1),2412,166000,40395,43000,21,https://salt.tikicdn.com/ts/product/90/10/26/6dbaa5ba3e5cfaba960c89788f90b6f6.png,1,209000,209000,5.0,225
98,195801686,Black Jack - Tập 13 (Bìa Mềm),1002,28600,40395,1400,5,https://salt.tikicdn.com/ts/product/50/28/1a/950e5ca1065b896a547f067d23089620.jpg,1,30000,30000,5.0,121
99,77774625,"Nghệ Thuật Tập Trung - Nâng Cao Năng Suất, Tối Ưu Thời Gian, Hiệu Quả Bất Ngờ",10365,69200,40395,29800,30,https://salt.tikicdn.com/ts/product/92/b3/a8/d3d67f85bef49aacd6cd886eb2df7f7e.jpg,1,99000,99000,4.8,1751
100,75307228,Sách OSHO Yêu - Being In Love - Yêu Trong Tỉnh Thức,891173,110100,40395,57900,34,https://salt.tikicdn.com/ts/product/0e/c1/12/34674efdedcbb3029f58e58724822afb.jpg,1,168000,168000,5.0,2077
101,197344441,Như Cơn Gió Thoảng - Nghĩ Về Những Qui Luật Cuộc Sống,208,113000,40395,2000,2,https://salt.tikicdn.com/ts/product/24/62/d7/f55d7760c9a26bd3d317d2e856039b57.jpg,1,115000,115000,5.0,28
102,3014291,Máy Tính Khoa Học Casio FX-580VN X,37334,678000,40395,106000,14,https://salt.tikicdn.com/ts/product/2a/19/6d/a0ba47ab36e21d6336f02db925703394.png,1,784000,784000,4.8,5546
103,19792256,Chuyện Con Mèo Dạy Hải Âu Bay (Tái Bản 2019),29790,34400,40395,14600,30,https://salt.tikicdn.com/ts/product/25/cc/f6/7bd7740f40022347bab2e854699ef761.jpg,1,49000,49000,5.0,2741
104,106318762,Sách ID Tiếng Anh cho người mới bắt đầu - người mới mất gốc Cô Trang Anh,4200,159000,162100,91000,36,https://salt.tikicdn.com/ts/product/e1/d5/08/950861238cc1b543b190cf72e5c75f71.png,1,250000,250000,4.6,777
105,109505434,Bạn Không Thông Minh Lắm Đâu (Tái Bản)(Tặng kèm Bookmark),4116,90300,40395,48700,35,https://salt.tikicdn.com/ts/product/81/fc/2e/7f82b135edf1a41e34ee30fe9d225562.jpg,1,139000,139000,4.8,643
106,90622579,Tâm Lý Học - Nghệ Thuật Giải Mã Hành Vi,9170,103000,40395,47000,31,https://salt.tikicdn.com/ts/product/31/24/03/1a95ad38b07bb5845440c3c20e98862c.jpg,1,150000,150000,4.8,1726
107,104769768,Máy Tính CASIO FX580VN X,4276,678000,40395,106000,14,https://salt.tikicdn.com/ts/product/f8/7a/1a/f0888165d0492adda506b6ca0b09bf91.jpg,1,784000,784000,5.0,784
108,106185389,Tổng ôn ngữ pháp Tiếng Anh cô Trang Anh- Sách luyện thi THPT Quốc gia môn tiếng anh,7974,189000,162100,61000,24,https://salt.tikicdn.com/ts/product/7d/d7/8a/ecd94b86aace6900b6a7429b09c53dcb.jpg,1,250000,250000,4.8,2526
109,20917699,Làm Sao Học Ít Hiểu Nhiều,3501,80900,40395,47100,37,https://salt.tikicdn.com/ts/product/5b/7d/b7/cc733ca2ae3661e0024a8f812220f802.jpg,1,128000,128000,4.8,538
110,193614514,[Gift] Tặng 01 bookmark cho mỗi đơn hàng,1695,21000,272531,9000,30,https://salt.tikicdn.com/ts/product/92/1f/e1/a8d4c4e8446c2d1bda08bdb18882f581.jpg,1,30000,30000,0.0,0
111,112110014,TÂM LÝ HỌC ỨNG DỤNG,5069,85500,40395,43500,34,https://salt.tikicdn.com/ts/product/d2/4a/80/692f3c566e04962db2aa12e412ad4c40.jpg,1,129000,129000,4.8,673
112,7833728,Dạy Con Làm Giàu (Tập 1) - Để Không Có Tiền Vẫn Tạo Ra Tiền - Cha Giàu Cha Nghèo (Tái Bản),37418,48000,40395,32000,40,https://salt.tikicdn.com/ts/product/59/fc/6c/0c6f90e6d9db859e868e7e451abe4924.png,1,80000,80000,4.8,3541
113,69978860,Sói đội lốt Cừu - Kẻ hiếu chiến ngầm và các thủ thuật thao túng tâm lí,4515,75900,40395,34100,31,https://salt.tikicdn.com/ts/product/e7/e7/33/15318503c9b390eb08ae487885903a61.png,1,110000,110000,4.8,861
114,197558907,Bá Tước Tiểu Thư - Tập 4,320,27100,40395,2900,10,https://salt.tikicdn.com/ts/product/b6/5f/ac/a51e396673f7116ba089b51217f6aabc.png,1,30000,30000,5.0,41
115,173748415,Tâm Lý Học Mối Quan Hệ,3961,53900,40395,44100,45,https://salt.tikicdn.com/ts/product/fa/75/fb/652ee2d3b062330abcb60a5813b0ab04.png,1,98000,98000,5.0,356
116,80628929,Từ IQ Đến EQ - Nắm Bắt Thành Công Qua Trí Tuệ Cảm Xúc,6352,62000,40395,29000,32,https://salt.tikicdn.com/ts/product/95/0c/a1/5b30d38cbfd98b10e88a610ceed04eac.png,1,91000,91000,4.8,1134
117,147999778,Không Bao Giờ Là Thất Bại - Tất Cả Là Thử Thách (Ấn Bản Cập Nhật Đầy Đủ Nhất)(Bìa Cứng),9569,142000,40395,126000,47,https://salt.tikicdn.com/ts/product/23/79/0a/155484418299828695ed00d6c5f1d8ba.jpg,1,268000,268000,5.0,737
118,138107485,Mặt Dày Tâm Đen (Tái Bản),2920,127000,40395,42000,25,https://salt.tikicdn.com/ts/product/97/fe/11/7bcd838032cbf914e3146a8e29089479.jpg,1,169000,169000,5.0,330
119,103640412,Đừng Lựa Chọn An Nhàn Khi Còn Trẻ (Tái Bản),9901,78900,40395,20100,20,https://salt.tikicdn.com/ts/product/81/03/4e/d52f732e23405351da5c4d1f436ce01d.jpg,1,99000,99000,4.8,1715
120,91947689,7 Thói Quen Hiệu Quả (The 7 Habits Of Highly Effective People) - Stephen R. Covey - PACE Books,7875,187000,40395,63000,25,https://salt.tikicdn.com/ts/product/e5/c6/29/d13e7da83de73d6b8a4f34db43c074de.jpg,1,250000,250000,5.0,942
121,195969669,Chào Mừng Đến Lớp Học Đề Cao Thực Lực - 3,702,66000,40395,54000,45,https://salt.tikicdn.com/ts/product/93/c6/ed/5c5bc56d8f699255e88a029e4490e10e.jpg,1,120000,120000,5.0,170
122,168293266,Chiến Tranh Tiền Tệ - Phần 2 - Sự Thống Trị Của Quyền Lực Tài Chính ( Tái Bản 2022),3008,108000,40395,62000,36,https://salt.tikicdn.com/ts/product/a1/6a/9f/93f1351a402f36f084a859c62ee02875.jpg,1,170000,170000,5.0,376
123,196016785,Ikigami - Tập 08,554,33750,40395,11250,25,https://salt.tikicdn.com/ts/product/7c/d7/ee/89157fe68643bc204c562d06ae8405ad.png,1,45000,45000,5.0,75
124,103379147,Bạch Dạ Hành (Tái Bản),5168,164000,40395,45000,22,https://salt.tikicdn.com/ts/product/eb/fd/ee/9219b303dbaf0927cf7f522e09a5cde8.png,1,209000,209000,4.8,1124
125,174215347,Ajin - Boxset Số 3 (Tập 13 - 17) - Tặng Kèm Bookmark 3D,1352,96000,40395,174000,64,https://salt.tikicdn.com/ts/product/df/61/ac/b6b1744e3b80539e66325ab34578c547.jpg,1,270000,270000,4.8,214
126,72308265,Hoa Vẫn Nở Mỗi Ngày,5253,175000,40395,59000,25,https://salt.tikicdn.com/ts/product/2d/79/b8/69a511f17927aecf8b5f4e00c8b5e6bf.png,1,234000,234000,4.8,928
127,5067169,Luật Hấp Dẫn (Tái Bản),8360,66700,40395,22300,25,https://salt.tikicdn.com/ts/product/20/e6/13/5167a6f3962041dcb27cf7bc0e13b7b9.jpg,1,89000,89000,4.8,747
128,56454897,Hiệu Sách Nhỏ Ở Paris,6782,89400,40395,59600,40,https://salt.tikicdn.com/ts/product/7c/b3/79/3a28f8413e42d52a70e138c9ac48c1ab.png,1,149000,149000,4.8,1196
129,196923457,Blue Flag - Tập 2,371,36000,40395,9000,20,https://salt.tikicdn.com/ts/product/ca/d7/b3/51fc7de9c68ffbab8c1b250bb3e29c36.png,1,45000,45000,5.0,90
130,70224520,Băng keo dán nano 2 mặt siêu dính trong suốt dày 1mm dài 2m rộng 3cm và 5cm,3406,30000,16869,0,0,https://salt.tikicdn.com/ts/product/f5/f9/ce/d576abbb9b438c43ef77f3deb92384b3.jpg,1,30000,30000,4.6,497
131,274802501,Thần Số Học Ứng Dụng,11099,78000,40395,5800,7,https://salt.tikicdn.com/ts/product/81/47/55/75dec2ab26549c43e2a08bcbfdf8c295.jpg,1,83800,83800,4.8,1707
132,23416722,How The Body Works - Hiểu Hết Về Cơ Thể,6296,195000,40395,105000,35,https://salt.tikicdn.com/ts/product/43/75/42/d2a0fdd204a09da708d64978a270ceb4.jpg,1,300000,300000,4.8,1011
133,3608625,Payback Time - Ngày Đòi Nợ,32309,299000,7269,0,0,https://salt.tikicdn.com/ts/product/80/69/fd/dff44ed26b3c50229721eaead49cc4be.png,1,299000,299000,4.8,4420
134,197344439,Kingdom - Tập 34,453,40600,40395,4400,10,https://salt.tikicdn.com/ts/product/27/53/2b/3084f2bc02d53cee05b6a5500c6c404f.jpg,1,45000,45000,5.0,56
135,74341297,Không Sợ Chậm Chỉ Sợ Dừng ,15815,83900,40395,45100,35,https://salt.tikicdn.com/ts/product/e7/a3/44/3a6bfae41e33770e0deb0bc034ee019b.jpg,1,129000,129000,5.0,2957
136,82912488,Từ Tốt Đến Vĩ Đại (Tái bản 2021),10543,74000,40395,56000,43,https://salt.tikicdn.com/ts/product/84/f5/a2/8cd3d96f65304037a1f038c982e718e9.jpg,1,130000,130000,5.0,1244
137,7718737,Nghệ Thuật Tư Duy Rành Mạch (Tái Bản),11353,88400,40395,29600,25,https://salt.tikicdn.com/ts/product/ea/26/6a/a3ddb60453d65d3d7dd6e564e519299f.jpg,1,118000,118000,4.8,1012
138,184070223,OSHO - Cảm Xúc,3038,128000,40395,60000,32,https://salt.tikicdn.com/ts/product/e9/38/63/0b0f480502cc58c8da2b6b60895eec6b.jpg,1,188000,188000,5.0,301
139,27582931,How Money Works - Hiểu Hết Về Tiền,9703,211000,40395,89000,30,https://salt.tikicdn.com/ts/product/2c/ac/1e/176e2f69a96e15be4f8968d3ae2594f3.png,1,300000,300000,4.7,1421
140,139303869,Nghệ Thuật Tinh Tế Của Việc Đếch Quan Tâm (Tái Bản),4713,95900,40395,32100,25,https://salt.tikicdn.com/ts/product/f1/8b/1d/9bf6331eb34007b732396232fbf39fce.jpg,1,128000,128000,5.0,513
141,140416370,Dòng Chảy,7042,160000,40395,68000,30,https://salt.tikicdn.com/ts/product/d5/cd/29/3b2688766207fd90580d2a9813aa2545.JPG,1,228000,228000,5.0,666
142,72001057,Chiến Tranh Tiền Tệ - Phần III,4262,117000,40395,58000,33,https://salt.tikicdn.com/ts/product/ec/f1/e8/de3c9b93a0ef07f8b21e5d5169a4009b.jpg,1,175000,175000,5.0,729
143,76013378,Storytelling With Data - Kể Chuyện Thông Qua Dữ Liệu (Cuốn Cẩm Nang Hướng Dẫn Trực Quan Hóa Dữ Liệu),11818,255000,40395,64000,20,https://salt.tikicdn.com/ts/product/6f/04/65/b067492450ad69804fb7671e6c5a9ee9.jpg,1,319000,319000,5.0,1883
144,157255752,Sức Mạnh Của Hiện Tại (Tái Bản),2444,115000,40395,53000,32,https://salt.tikicdn.com/media/catalog/producttmp/bf/87/95/ed6444fd32213416c0f8f77e5fe0fb10.jpg,1,168000,168000,5.0,241
145,195801662,Ngôi Sao Vườn Nữ Sinh - Tập 1,471,47400,40395,2600,5,https://salt.tikicdn.com/ts/product/25/e7/1f/090d12d39e2e998bbe8845bd9f04b521.jpg,1,50000,50000,5.0,83
146,8835159,Đời Ngắn Đừng Ngủ Dài (Tái Bản),45376,61200,40395,23800,28,https://salt.tikicdn.com/ts/product/f1/93/06/7f312c34d6a7932c1df5434c1324d2fe.jpg,1,85000,85000,4.8,3154
147,127844385,Kiêu Hãnh Và Định Kiến (Tái Bản),3176,86900,40395,29100,25,https://salt.tikicdn.com/ts/product/ff/cf/21/96d42ac5436c91c00015366fcaa34fc3.png,1,116000,116000,4.8,538
148,181699664,Những Ngã Tư Và Những Cột Đèn,949,100000,40395,100000,50,https://salt.tikicdn.com/ts/product/a1/26/58/a690207f175608fcc366f803c8850e1c.jpg,1,200000,200000,4.8,131
149,148760924,How Management Works - Hiểu Hết Về Quản Lý,2218,264000,40395,66000,20,https://salt.tikicdn.com/ts/product/14/5c/36/369093950c572eb1283d7a1e704a8f1c.png,1,330000,330000,4.8,281
150,194205608,Cherry Magic - Tập 2,1009,85100,40395,23900,22,https://salt.tikicdn.com/ts/product/ed/dd/97/855bbe758ee7fdb78b861d1560d8849f.jpg,1,109000,109000,5.0,287
151,59262880,Sách Người Bán Hàng Vĩ Đại Nhất Thế Giới (Tái Bản 2020),6803,101000,40395,47000,32,https://salt.tikicdn.com/ts/product/df/c0/cf/76678531ba4a291eea194def645924f5.jpg,1,148000,148000,4.8,938
152,192115858,Chú Thuật Hồi Chiến -  Tập 5,3085,26300,40395,3700,12,https://salt.tikicdn.com/ts/product/5f/1c/a8/139ea9159519f28b9d46a9e7c7cfed53.jpg,1,30000,30000,5.0,924
153,196851308,Dragon Ball Full Color - Phần Năm: Truy Lùng Cell Bọ Hung - Tập 4,547,67700,40395,9300,12,https://salt.tikicdn.com/ts/product/3d/0f/4b/6064cef0c1c482678434c5ebdc3ae939.jpg,1,77000,77000,5.0,63
154,167972598,Tôi Thích Bản Thân Nỗ Lực Hơn (Ấn Bản Kỷ Niệm),2305,80400,40395,39600,33,https://salt.tikicdn.com/ts/product/2e/69/c9/e24479d8554babc2e59cc42472645dc2.jpg,1,120000,120000,4.8,323
155,107802183,Sách Sức Mạnh Tiềm Thức (Tái Bản) (Bìa Mềm),8439,83800,40395,44200,35,https://salt.tikicdn.com/media/catalog/producttmp/ea/80/aa/becf674be5294be90a47551c68191737.jpg,1,128000,128000,5.0,908
156,173882437,8 Vụ Án Hoàn Hảo - Vạch Trần Tâm Lý Kẻ Phạm Tội,2903,95100,40395,49900,34,https://salt.tikicdn.com/ts/product/ae/bc/69/b190cb8d06b0858c0e0d450858367098.jpg,1,145000,145000,4.8,521
157,94173458,Khuyến Học (Tái Bản),5661,58400,40395,6600,10,https://salt.tikicdn.com/ts/product/bc/94/41/f4646aacc269d010c6c1dfc3fec552d0.jpg,1,65000,65000,5.0,712
158,120219394,Tôi Nói Gì Khi Nói Về Chạy Bộ,4822,49400,40395,26600,35,https://salt.tikicdn.com/ts/product/7b/61/80/1f707faf6171377dc7026c3739b6a678.jpg,1,76000,76000,5.0,528
159,192124399,Blue Period Tập 2,2084,43200,40395,4800,10,https://salt.tikicdn.com/ts/product/b0/1f/34/e7fee85ce948d37059e4ddd277776d49.jpg,1,48000,48000,5.0,468
160,179546672,Làm Sao Học Hết Được Nhân Sinh,1862,101400,40395,67600,40,https://salt.tikicdn.com/ts/product/4b/fe/f3/442e2b2bf38e906c8b9380f2e4b06361.jpg,1,169000,169000,5.0,168
161,185067342,Tô Bình Yên Vẽ Hạnh Phúc (Tái Bản),3957,59600,40395,28400,32,https://salt.tikicdn.com/ts/product/25/4c/2a/4fea88cd73da827e4b5b7e8ba9c29b80.jpg,1,88000,88000,5.0,390
162,11338092,Hiểu Về Trump,21,186000,7082,63000,25,https://salt.tikicdn.com/ts/product/24/0e/e6/8f12257d3e87e5bdd51eca582d64fe07.jpg,1,249000,249000,5.0,1
163,173763072,Tâm Lý Học Hẹn Hò - Nghệ Thuật Giao Tiếp Trong Tình Yêu,2247,72800,40395,36200,33,https://salt.tikicdn.com/ts/product/3c/2d/ab/d994c280ba9c02370fc8a54778d18521.png,1,109000,109000,4.8,222
164,108684605,Trí Thông Minh Của Sự Tinh Tế,4605,64000,40395,25000,28,https://salt.tikicdn.com/ts/product/a6/64/64/f77f2dfe693e3c9de8f193d1bc92ed11.jpg,1,89000,89000,4.8,499
165,85396163,Combo 2 Cuốn: Yêu Những Điều Không Hoàn Hảo + Bước Chậm Lại Giữa Thế Gian Vội Vã (Tái Bản),5382,134400,40395,89600,40,https://salt.tikicdn.com/ts/product/e2/8b/bb/83c1384f801eee00f97e163d605a0e7c.jpg,1,224000,224000,5.0,919
166,163703151,Chuyện Kể Rằng Có Nàng Và Tôi,3047,43100,40395,28900,40,https://salt.tikicdn.com/ts/product/68/d0/5c/978e8e91697b138e99d4db53a4531d16.jpg,1,72000,72000,4.8,689
167,196409700,Công Chúa Ma Cà Rồng Quyền Năng Chỉ Muốn Có Một Người Em Gái Mà Thôi,430,127000,40395,48000,27,https://salt.tikicdn.com/ts/product/e7/34/5a/a161ea448f67f3a96ae25beba280201d.jpg,1,175000,175000,5.0,145
168,55605170,Cơ Thể Tự Chữa Lành: Thực Phẩm Thay Đổi Cuộc Sống,7397,137000,40395,48000,26,https://salt.tikicdn.com/ts/product/7c/29/9e/532eea3dbae4766dcc9b9ecec89d82ee.jpg,1,185000,185000,4.8,1054
169,76776245,Nghệ Thuật Tư Duy Phản Biện,5410,90200,40395,38800,30,https://salt.tikicdn.com/ts/product/47/ee/1d/6cb83c7466f83ad846880683c4c10a7e.jpg,1,129000,129000,4.8,706
170,52329763,Kafka bên bờ biển (Tái Bản 2020),6277,94800,40395,63200,40,https://salt.tikicdn.com/ts/product/b2/ff/ff/4aff5a5c2864d4dfb695823af5a59871.jpg,1,158000,158000,4.8,1138
171,105483727,Ổn Định Hay Tự Do,5886,92800,40395,36200,28,https://salt.tikicdn.com/ts/product/7b/33/33/13d688679dc650a6454703a0c8b195a3.jpg,1,129000,129000,4.8,1041
172,194205620,Người Hướng Nội Trong Thế Giới Hướng Ngoại,653,78700,40395,26300,25,https://salt.tikicdn.com/ts/product/2f/78/b2/130536f1f9ffd4bced3742a2176cd70d.jpg,1,105000,105000,4.8,56
173,124767703,Cân Bằng Cảm Xúc Cả Lúc Bão Giông (Tặng Kèm Bookmark)(Tái Bản),8211,65100,40395,39900,38,https://salt.tikicdn.com/ts/product/a1/a8/d3/58593a4851b2b8824e5b0a6c0b90f72c.jpg,1,105000,105000,5.0,748
174,105663942,Hành Trình Về Phương Đông (Tái Bản 2021),4937,74400,40395,43600,37,https://salt.tikicdn.com/ts/product/1b/00/76/63a05991f224ef1c8022e8d5b1d35e4f.png,1,118000,118000,5.0,468
175,197353399,Học Viện Siêu Anh Hùng Vigilantes - My Hero Academia Illegals - Tập 1: Đã Có Ta Ở Đây,661,24000,40395,6000,20,https://salt.tikicdn.com/ts/product/25/a4/69/9e3d55f1d0d897aa5bb57d1a5fe79d8e.png,1,30000,30000,5.0,39
176,179735872,Sách Tâm Lý Dành Cho Người Nhạy Cảm,2509,62200,40395,26800,30,https://salt.tikicdn.com/ts/product/1a/43/7d/744ea95a15b9eb11b43c94830257ea2a.jpg,1,89000,89000,4.8,248
177,195187480,"Thiên Quan Tứ Phúc - Tập 6 (Tiểu thuyết, đam mỹ)",1093,105400,40395,53600,34,https://salt.tikicdn.com/ts/product/25/98/36/5e929011066b444c2cddac0ecbe3817a.png,1,159000,159000,5.0,237
178,171549981,Cuộc Diễu Hành Thầm Lặng,1689,148000,40395,50000,25,https://salt.tikicdn.com/ts/product/d6/be/44/3a27b18654eee72d305665fe32dbae39.jpg,1,198000,198000,5.0,252
179,273624916,[ Trạm Đọc Official ]  Trí Tuệ Do Thái (Tái Bản),1,142000,103533,47000,25,https://salt.tikicdn.com/ts/product/3a/76/7c/b111bad1213a88091fc4778133b7fee4.png,1,189000,189000,0.0,0
180,154245455,Combo 2 Cuốn Nghiền Từ Vựng Tiếng Anh: Học Qua Gốc Từ Bằng Hình Ảnh - Gốc Từ Là Bí Quyết Để Ghi Nhớ Hàng Nghìn Từ Vựng,2042,165000,40395,105000,39,https://salt.tikicdn.com/ts/product/50/fd/12/02e0cd5e3d2fd1d199bbe0f0296be39f.jpg,1,270000,270000,5.0,261
181,158019962,Combo 3 Cuốn Bộ Sách: Nuôi Con Không Phải Là Cuộc Chiến 2 (Tái Bản),3341,248477,40395,128523,34,https://salt.tikicdn.com/ts/product/42/c6/84/2ff2aeac6e331d7d2b641969e3c87090.png,1,377000,377000,5.0,265
182,195885688,Dragon Quest - Dấu Ấn Roto (Dragon Quest Saga Emblem Of Roto) Perfect Edition - Tập 9,629,65900,40395,9100,12,https://salt.tikicdn.com/ts/product/17/39/04/85610c78daac0822a01a22f9b9fa54d3.jpg,1,75000,75000,5.0,68
183,8886007,Ngàn Mặt Trời Rực Rỡ (Tái Bản),9259,78000,40395,52000,40,https://salt.tikicdn.com/ts/product/86/74/8d/65dae82f1b5dee4a5adee138d6da7160.png,1,130000,130000,4.8,1285
184,100931416,Bắt Đầu Với Câu Hỏi Tại Sao - Nghệ Thuật Truyền Cảm Hứng Trong Kinh Doanh (Tái Bản),5721,74000,40395,35000,32,https://salt.tikicdn.com/ts/product/14/c7/f1/5e79b5367280de7a1b5f4d4b3e13356d.jpg,1,109000,109000,4.8,471
185,71907876,Từ Điển Tiếng “Em”,21155,42780,40395,26220,38,https://salt.tikicdn.com/ts/product/b5/ab/43/c2f25c6a936510429f81d3b2e5e3d9c0.png,1,69000,69000,4.8,5263
186,540039,Giáo Trình Chuẩn HSK 1 - Bài Học (Kèm file MP3),7427,139000,40395,59000,30,https://salt.tikicdn.com/media/catalog/product/h/s/hsk1 bh.u547.d20160825.t133511.382989.jpg,1,198000,198000,4.8,910
187,168234714,Cư Xử Như Đàn Bà Suy Nghĩ Như Đàn Ông,2523,65400,40395,43600,40,https://salt.tikicdn.com/ts/product/ab/f9/93/1d176ab6595aab4b5da5be7f55985f24.jpg,1,109000,109000,4.8,192
188,13333355,Đọc Nhiều Nhớ Được Bao Nhiêu?,4380,76800,40395,41200,35,https://salt.tikicdn.com/ts/product/de/db/a3/3985dd3cf5216b6322feaca7fabb5e37.png,1,118000,118000,4.8,720
189,139567621,Thức Tỉnh Mục Đích Sống (Tái Bản),3060,101000,40395,47000,32,https://salt.tikicdn.com/ts/product/bb/30/68/d998e0ce28e41bc3940ba05d5e94f076.png,1,148000,148000,5.0,279
190,196422809,Bá Tước Tiểu Thư - Tập 3,285,28600,40395,1400,5,https://salt.tikicdn.com/ts/product/c9/59/18/ee3797584bf1a2703f35d8607a34c6e5.jpg,1,30000,30000,5.0,42
191,191920180,Cherry Magic - Tập 1,1032,65400,40395,43600,40,https://salt.tikicdn.com/ts/product/07/7a/f4/cf1866f6dbcda8cbb04611b659bd25d3.jpg,1,109000,109000,5.0,301
192,149089470,Những Vị Thần Nước Mỹ,2169,192000,40395,58000,23,https://salt.tikicdn.com/ts/product/2e/70/b8/c827f51270ef91011354b9cb346bd9a6.jpg,1,250000,250000,4.7,432
193,126743459,Fear - Sợ Hãi (Hóa Giải Sợ Hãi Bằng Tình Thương),4788,71940,40395,37060,34,https://salt.tikicdn.com/ts/product/48/d6/19/ac3074ed246ad94287c665a80cca519c.jpg,1,109000,109000,5.0,511
194,194960238,Slam Dunk - Deluxe Edition - Tập 10,530,52800,40395,7200,12,https://salt.tikicdn.com/ts/product/20/0b/72/04e092fd81c995a8c2c2dc22d39450b4.png,1,60000,60000,4.8,58
195,35191892,21 Bài Học Cho Thế Kỷ 21,19900,165000,40395,44000,21,https://salt.tikicdn.com/ts/product/d8/11/53/dc97e8751f7ae5cb4a10fd7d83bbb0af.png,1,209000,209000,4.6,1778
196,104741661,Combo 2 Tập : 999 Lá Thư Gửi Cho Chính Mình (Tái Bản),28702,193000,40395,65000,25,https://salt.tikicdn.com/ts/product/b6/74/e0/d93947acdb5e35f839d5c7c564d31dad.jpg,1,258000,258000,5.0,1205
197,14508205,Sổ tay thực hành 66 ngày thử thách,7925,89000,7269,0,0,https://salt.tikicdn.com/ts/product/ec/65/37/3a60f69d61222d8456394ab867161fba.jpg,1,89000,89000,4.7,411
198,197781975,Dr.Slump Ultimate Edition Tập 12,583,57000,40395,3000,5,https://salt.tikicdn.com/ts/product/a6/fb/aa/d3b815af684d7c904ec94a1466aa44ae.jpg,1,60000,60000,5.0,59
199,54422942,Tôi Quyết Định Sống Cho Chính Tôi (Tái Bản 2020),5647,54560,40395,33440,38,https://salt.tikicdn.com/ts/product/cd/d4/93/3d8c0302aa7c07316dd2b7b44d7dd968.png,1,88000,88000,5.0,1094
200,167210779,Quyền Lực,1147,100750,40395,54250,35,https://salt.tikicdn.com/ts/product/93/10/fe/609978b763beec3e31d2a58d79314c29.png,1,155000,155000,4.8,134
201,196016781,Kingdom - Tập 33,415,40600,40395,4400,10,https://salt.tikicdn.com/ts/product/b6/95/46/05384c29757cfb82a93f962c2110814d.jpg,1,45000,45000,5.0,42
202,152740748,Lối Sống Tối Giản Của Người Nhật (Tái Bản),2846,78540,40395,40460,34,https://salt.tikicdn.com/ts/product/42/f4/cf/cd708d98c28b0f673135cf92c9323672.png,1,119000,119000,4.8,348
203,54748899,Sách Muôn Kiếp Nhân Sinh (Bìa Mềm) - Nguyên Phong,50225,123000,40395,45000,27,https://salt.tikicdn.com/media/catalog/producttmp/af/95/32/80640c43b22ada78e777cb4c334a79fb.jpg,1,168000,168000,4.8,5309
204,77105730,Tàn Ngày Để Lại (Bìa Cứng),3886,127000,40395,42000,25,https://salt.tikicdn.com/ts/product/af/14/16/797c87e57d36061a0132729c618aaa79.jpg,1,169000,169000,4.8,706
205,45902241,Tìm Mình Trong Thế Giới Hậu Tuổi Thơ,15900,113000,40395,29000,20,https://salt.tikicdn.com/ts/product/23/a8/b0/6ead9d0895e1762e44125bfe701486d6.jpg,1,142000,142000,4.8,1673
206,3608623,Bí Mật Của Phan Thiên Ân,25522,69000,7269,0,0,https://salt.tikicdn.com/ts/product/3a/61/36/9099e63bdcd48437ba08cfc43bbd18ea.jpg,1,69000,69000,4.8,2412
207,73878873,Tư Duy Sâu,8596,64500,40395,26500,29,https://salt.tikicdn.com/ts/product/3b/62/d2/56fb29c5f2906eb91acc846527ca9d53.jpg,1,91000,91000,4.8,1674
208,750578,Khi Hơi Thở Hóa Thinh Không,61417,71000,40395,38000,35,https://salt.tikicdn.com/ts/product/f6/a2/a1/90034af8597074f3acd165cdcf84b60d.png,1,109000,109000,4.7,2236
209,87226756,"Những Đêm Không Ngủ, Những Ngày Chậm Trôi",9152,67000,40395,19000,22,https://salt.tikicdn.com/ts/product/f5/25/34/5b076431a666f74c1a457e9ed917356b.png,1,86000,86000,4.8,2086
210,57110087,Siêu Cò – How To Be A Power Connector,13495,249000,7269,0,0,https://salt.tikicdn.com/ts/product/2e/1b/21/fda946fe5cfb14388487014fabe8c200.png,1,249000,249000,4.8,2240
211,12377498,Bố Con Cá Gai (Tái Bản 2019),8419,67100,40395,28900,30,https://salt.tikicdn.com/ts/product/66/6d/41/f14ad89822723bee0fe5d6a5af78ab87.png,1,96000,96000,5.0,1242
212,185242031,The Shining - Thị Kiến,967,215000,40395,54000,20,https://salt.tikicdn.com/ts/product/d7/ac/f7/769b94f36c9aa4d7c8eaea345ae0a237.jpg,1,269000,269000,4.8,174
213,170708233,Thay Đổi Tí Hon - Hiệu Quả Bất Ngờ Atomic Habits (Tái Bản Lần 4),7520,132000,40395,57000,30,https://salt.tikicdn.com/ts/product/78/89/97/2d0d782be008d8208c6bc8a0a425149c.jpg,1,189000,189000,4.8,654
214,196515661,Văn Phòng Thám Tử Quái Vật - Tập 12,367,23900,40395,6100,20,https://salt.tikicdn.com/ts/product/f8/c6/70/c0bc0dba55a00bc4be6403c579d74ade.png,1,30000,30000,5.0,58
215,57762732,Nhà Đầu Tư Thông Minh (Tái Bản 2020),16891,140000,40395,59000,30,https://salt.tikicdn.com/ts/product/52/e1/32/b6cec9411dd6c1f2f0b67be9a1477965.png,1,199000,199000,4.8,2909
216,158019964,Combo 4 Cuốn Bộ Sách: Nuôi Con Không Phải Là Cuộc Chiến (Tái Bản),2476,340000,40395,166000,33,https://salt.tikicdn.com/ts/product/49/c4/04/5df954bb4111e8be6d46b1b1ffc5f7c3.png,1,506000,506000,5.0,237
217,191571494,Black Jack - Tập 12,973,28400,40395,1600,5,https://salt.tikicdn.com/ts/product/d8/a1/1e/bb5e7ad15f90b8ae71d1115aa41c0ddf.png,1,30000,30000,5.0,117
218,187827003,Không Diệt Không Sinh Đừng Sợ Hãi (TB5),27373,76900,40395,33100,30,https://salt.tikicdn.com/ts/product/a0/bf/43/267e59580ba829ef33eb1999199dafd5.jpg,1,110000,110000,5.0,1773
219,53532186,Tuyệt kỹ Giao dịch bằng đồ thị nến Nhật – Japanese Candlestick Charting Techniques,13159,499000,7269,0,0,https://salt.tikicdn.com/ts/product/da/a4/b9/a29ecb684b5dc882fc26250a47fe6aac.png,1,499000,499000,4.8,2311
220,183058543,OSHO - Trưởng Thành,1232,85300,40395,42700,33,https://salt.tikicdn.com/ts/product/bd/15/59/71132b6c7eca83baa072d4f7dc1579e8.jpg,1,128000,128000,5.0,119
221,17336360,Lolita (Tái Bản 2019),4465,83200,40395,44800,35,https://salt.tikicdn.com/ts/product/ae/e3/b2/1d4966e768d0a38d1b9e3fd27a03123e.jpg,1,128000,128000,4.7,852
222,196923451,Vua Sáng Chế - Tập 17,343,20000,40395,0,0,https://salt.tikicdn.com/ts/product/ee/18/60/6b491f8dd6c92c23bf2cd33f7b178d37.png,1,20000,20000,5.0,40
223,378448,Nhà Giả Kim,5969,69000,9778,0,0,https://salt.tikicdn.com/ts/product/83/30/87/737846efdb9f28f0f51352cacf9225c5.jpg,1,69000,69000,5.0,1016
224,162844699,Tạm Biệt Tôi Của Nhiều Năm Về Trước,4237,74900,40395,20100,21,https://salt.tikicdn.com/ts/product/fc/d6/ca/8fb29f517685c694457f284b2230e19a.jpg,1,95000,95000,4.8,650
225,197781972,Đi Hát Karaoke Đi,821,50000,40395,0,0,https://salt.tikicdn.com/ts/product/64/75/30/6ddc9be10f3cc9685f811671cee6290f.jpg,1,50000,50000,5.0,167
226,196515664,Anh Em Phi Hành Gia - Tập 33,289,32000,40395,13000,29,https://salt.tikicdn.com/ts/product/59/ab/2f/90021f465b423769ecf2d3bfe8fa7dc1.jpg,1,45000,45000,5.0,35
227,90887853,Mình Chỉ Là Người Bình Thường (Sách Tô Màu),5982,93700,40395,44300,32,https://salt.tikicdn.com/ts/product/b4/4e/93/b6c58f71c1f582007406691b07dcd464.png,1,138000,138000,4.8,1558
228,50414368,Án Mạng Mười Một Chữ,8193,71500,40395,38500,35,https://salt.tikicdn.com/ts/product/32/cd/a3/d211744b54f3c45ddee85b106588fa74.png,1,110000,110000,4.8,1343
229,115266692,Sách - Ám Ảnh Sợ Xã Hội - Chạy Trốn Hay Đối Mặt,3747,98900,40395,26100,21,https://salt.tikicdn.com/ts/product/a7/e2/59/e8880848356295eaa88108982ce4e3ba.jpg,1,125000,125000,4.8,743
230,84970841,Men Chase Women Choose - Chuyện Tình Yêu Bạn Biết Được Bao Nhiêu?,4453,65100,40395,43900,40,https://salt.tikicdn.com/ts/product/bd/fc/09/45e788ca27f8661f938a47291d06c172.png,1,109000,109000,5.0,710
231,145289356,"Sách Atomic Habits - Thay Đổi Tí Hon, Hiệu Quả Bất Ngờ ( Những Thay Đổi Nhỏ Tạo Nên Thành Công Lớn/ Tặng kèm Bookmark)",554,160000,7082,29000,15,https://salt.tikicdn.com/ts/product/e2/32/b3/085ee546b06b792e847edd88b02b8f15.jpg,1,189000,189000,5.0,40
232,173865570,Một Cuốn Sách Về Chủ Nghĩa Tối Giản (Tái bản 2022),5063,129000,264955,0,0,https://salt.tikicdn.com/ts/product/34/b8/2d/8caeb757835c35c37b7598a341fe1b02.png,1,129000,129000,5.0,647
233,9948009,Dám Hạnh Phúc,7087,82400,40395,27600,25,https://salt.tikicdn.com/ts/product/23/64/9d/af14cd3e25aca97d053611cc6274a877.jpg,1,110000,110000,4.8,547
234,186237324,Thiên quan tứ phúc - Tập 5 (Tiểu thuyết đam mỹ) - Tặng kèm 1 bookmark 2 mặt,844,105400,40395,53600,34,https://salt.tikicdn.com/ts/product/ab/fc/43/f7d836dfdc3b2745af30eff0cd7ee92f.jpg,1,159000,159000,5.0,174
235,128649312,21 Nguyên Tắc Tự Do Tài Chính (Tái Bản),1907,38400,40395,16600,30,https://salt.tikicdn.com/ts/product/4f/cd/2b/90bbfac6b4ee63a21837417ff3b9d28a.png,1,55000,55000,5.0,174
236,641906,Bí Mật Của Naoko,13644,70200,40395,37800,35,https://salt.tikicdn.com/ts/product/92/c8/07/a2b7bc61685f5dafc6f7e1e15c9f18f0.png,1,108000,108000,4.7,1417
237,274724185,Muốn An Được An,5603,42841,40395,22159,34,https://salt.tikicdn.com/ts/product/0a/fc/1d/e5e1b4bb6529435f11efb8dfcd49350d.jpg,1,65000,65000,5.0,463
238,179546078,Luật Hấp Dẫn - Quy Luật Về Sức Mạnh Tâm Trí Và Phát Huy Năng Lượng Tích Cực Để Làm Chủ Định Mệnh,2448,80500,40395,58500,42,https://salt.tikicdn.com/ts/product/e3/f1/63/9431f3eab614fd5fbc488333d33e0597.png,1,139000,139000,4.7,182
239,145288026,Chia Rẽ - Tại Sao Chúng Ta Đang Sống Trong Thời Đại Của Những Bức Tường,2798,150000,40395,50000,25,https://salt.tikicdn.com/ts/product/2c/a1/76/1779d5f6e33c575dadfc2fd4f374e1cb.jpg,1,200000,200000,4.8,401
240,86517373,Khoa Học Về Nấu Ăn - The Science Of Cooking,7178,269000,40395,81000,23,https://salt.tikicdn.com/ts/product/1b/dc/ae/ef40e5729cd2493f41764c1c5f3199bf.png,1,350000,350000,4.8,1349
241,104074997,Kỹ Năng Bán Hàng Tuyệt Đỉnh (Tái Bản),3249,77900,40395,42100,35,https://salt.tikicdn.com/ts/product/47/ae/46/7a9a5bff41ce925b4a4dd9236a3714b7.jpg,1,120000,120000,5.0,278
242,2496281,Đồi Gió Hú (Tái Bản),4540,80900,40395,39100,33,https://salt.tikicdn.com/ts/product/45/7a/6e/6f44bb316c48d7d2f828d973cdb18508.png,1,120000,120000,4.8,602
243,197990865,Dragon Quest - Dấu Ấn Roto (Dragon Quest Saga Emblem Of Roto) Perfect Edition - Tập 10,629,71900,40395,3100,4,https://salt.tikicdn.com/ts/product/8f/d4/9d/c366c3b73ca1d91954873db694bb7402.jpg,1,75000,75000,5.0,73
244,73515859,Sách OSHO - Can Đảm Là Chính Mình Trong Thế Giới Hiểm Nguy,2169,63300,40395,24700,28,https://salt.tikicdn.com/ts/product/85/2f/2c/48d021b4bdbc5a679e8d05dbda2426e9.jpg,1,88000,88000,5.0,270
245,11122712,Bộ sách Làm Giàu Từ Chứng Khoán (How To Make Money In Stock) phiên bản mới + Hướng Dẫn Thực Hành CANSLIM Cho Người Mới Bắt Đầu,15807,700000,7269,0,0,https://salt.tikicdn.com/ts/product/6a/65/73/04fcf0bf3216f7478d50c928fbdfc200.png,1,700000,700000,4.8,2431
246,196851314,Nữ Chúa Tuyết,364,36100,40395,3900,10,https://salt.tikicdn.com/ts/product/b5/a4/4f/6ead37f02e58bfdcf8bf556deddae7f6.png,1,40000,40000,5.0,70
247,130233544,Mèo Và Triết Lý Nhân Sinh - Mèo Đã Dạy Chúng Ta Điều Gì Về Cuộc Sống,3654,140000,40395,69000,33,https://salt.tikicdn.com/ts/product/8f/06/26/ea439ed40df8876e3bce8f51ca934f46.jpg,1,209000,209000,4.8,510
248,168559521,Sự Trung Thực Của Xác Chết – Ghi Chép Của Một Nhà Pháp Y,1766,69200,40395,29800,30,https://salt.tikicdn.com/ts/product/30/ed/22/6b5cfac0a16e9350e83252980e33aef4.jpg,1,99000,99000,5.0,276
249,102629318,999 Lá Thư Gửi Cho Chính Mình (*) - Tập 1 - Mong Bạn Trở Thành Phiên Bản Hoàn Hảo Nhất (Tái bản),5649,87900,40395,41100,32,https://salt.tikicdn.com/ts/product/cf/fb/99/67d3891ba9bdca8d931d7cbb531ec153.jpg,1,129000,129000,5.0,861
250,7982628,Suối Nguồn (Tái Bản),12558,226000,40395,154000,41,https://salt.tikicdn.com/ts/product/7f/63/da/ef6c79487ec3b3aec8116f6b79a04a5b.jpg,1,380000,380000,4.8,1403
251,155550591,Dinh Dưỡng Học Bị Thất Truyền - Dinh Dưỡng Đẩy Lùi Bệnh Tật,4057,107000,40395,71000,40,https://salt.tikicdn.com/ts/product/a1/37/1a/bbc55422aa63e61695b3ed8dab74e26f.jpg,1,178000,178000,5.0,322
252,35283863,Lược Sử Thế Giới,5753,248000,40395,72000,23,https://salt.tikicdn.com/ts/product/10/db/25/b3eaa7a439f12d49395d9456ae2800b8.png,1,320000,320000,4.6,838
253,179063952,Khi Mọi Điểm Tựa Đều Mất,1495,68200,40395,29800,30,https://salt.tikicdn.com/media/catalog/producttmp/53/13/69/31a3e835d8cdd7dd95ad1197f3eb1066.jpg,1,98000,98000,5.0,131
254,11368965,Combo Giáo Trình Chuẩn HSK 1 - Bài Học (Kèm 1 MP3) và Giáo Trình Chuẩn HSK 1 - Bài Tập (Kèm 1 MP3) ( Tặng Kèm Viết ),3899,284800,7554,71200,20,https://salt.tikicdn.com/ts/product/07/74/48/a9a67f9e2da246c8452ef4394bb966f4.jpg,1,356000,356000,5.0,657
255,828621,Dolocher (Trinh Thám),678,79500,107665,79500,50,https://salt.tikicdn.com/ts/product/9c/c0/eb/40739a82e4dfe9740ba00a985ee5b6fd.jpg,1,159000,159000,4.7,97
256,106864418,Combo 10 Cuốn: Chuyện Xóm Gà,1557,435000,40395,145000,25,https://salt.tikicdn.com/ts/product/7e/26/6b/34e50031406e666edbae89b86919fd48.jpg,1,580000,580000,5.0,220
257,540040,Giáo Trình Chuẩn HSK 1 - Bài Tập (Kèm file MP3),4722,111000,40395,47000,30,https://salt.tikicdn.com/ts/product/fb/f8/70/db3fbd5ea24b446d3a02d8b0ab95fd73.png,1,158000,158000,4.8,602
258,194960244,Fullmetal Alchemist - Cang Giả Kim Thuật Sư - Fullmetal Edition - Tập 16,572,65500,40395,3500,5,https://salt.tikicdn.com/ts/product/da/ef/21/c46c3c9be21b4790c43336820ac16f87.png,1,69000,69000,5.0,50
259,179546070,Luật Hấp Dẫn - Quy Luật Về Sức Mạnh Của Linh Hồn Và Năng Lượng Chữa Lành Cơ Thể Từ Bên Trong,3274,92800,40395,36200,28,https://salt.tikicdn.com/ts/product/22/39/e8/8f761d08cd515afc482e278f8f24bc23.jpg,1,129000,129000,5.0,270
260,52584834,Tư Duy Hệ Thống Trong Công Việc,6224,59000,40395,30000,34,https://salt.tikicdn.com/ts/product/07/d2/78/2e7ad745cbe0ba3426f5d074469b21f1.jpg,1,89000,89000,4.6,696
261,191782162,Trên Đường Băng (Tony Buổi Sáng),1807,65000,40395,40000,38,https://salt.tikicdn.com/ts/product/f0/01/af/e86af26ce763dccb393f32d13a916a20.jpg,1,105000,105000,5.0,142
262,193434490,Ikigami - Tập 07,539,33750,40395,11250,25,https://salt.tikicdn.com/ts/product/18/e0/5f/f42da716e1cf93a202d184c3992f9e43.jpg,1,45000,45000,5.0,86
263,194104216,Văn Phòng Thám Tử Quái Vật - Tập 11,442,22500,40395,7500,25,https://salt.tikicdn.com/ts/product/5a/b5/a8/427e5828fdfda8a568ccc232fdfb7d8b.jpg,1,30000,30000,5.0,76
264,73316977,Hành Trình Của Linh Hồn (Tái Bản 2020),2947,90100,40395,38900,30,https://salt.tikicdn.com/ts/product/9d/8f/89/bd297567c4f44057b36ed33bdef3524a.jpg,1,129000,129000,5.0,373
265,56692532,Tôi Từng Nghĩ Mọi Thứ Sẽ Ổn Khi Trở Thành Người Lớn (Tặng Kèm 1 Bookmark),11233,66900,40395,29100,30,https://salt.tikicdn.com/ts/product/f9/fd/4c/9d2d0c8209c6f10fc0378c711fb987bd.jpg,1,96000,96000,4.8,2256
266,196515668,"Quán Rượu Dị Giới ""Nobu"" - Tập 11",218,37900,40395,2100,5,https://salt.tikicdn.com/ts/product/ee/96/71/ebb6c20f05da3a8800a889935b084b00.png,1,40000,40000,5.0,38
267,174842858,Sách Sức Mạnh Của Ngôn Từ (Tái Bản 2022),4184,108000,40395,0,0,https://salt.tikicdn.com/media/catalog/producttmp/83/ec/19/baafdb6382f4a2e293f6745bd3f31817.jpg,1,108000,108000,5.0,292
268,66090079,Cơ Thể Tự Chữa Lành: Giải Cứu Gan,5674,225000,40395,25000,10,https://salt.tikicdn.com/ts/product/5a/97/a3/a2ce0fcdaf04c873123f82ba5d6af7c6.jpg,1,250000,250000,5.0,908
269,21130350,Vụ Án LEROUGE (Trinh Thám),442,84000,107665,84000,50,https://salt.tikicdn.com/ts/product/76/75/f1/b6d5a7033262a995d2618c8f204ab85d.jpeg,1,168000,168000,4.8,79
270,126743464,Kế Hoạch Của Linh Hồn - Khám Phá Ý Nghĩa Cuộc Sống Mà Bạn Đã Lên Kế Hoạch Trước Khi Sinh Ra,1862,118100,40395,50900,30,https://salt.tikicdn.com/ts/product/6b/9e/a1/fff595d946359af53c418070688f85ae.jpg,1,169000,169000,5.0,218
271,176909221,Ngôi Nhà Bên Bờ Biển Xanh Thẳm,2154,118000,40395,56000,32,https://salt.tikicdn.com/ts/product/91/2f/ab/4bc923bdd3177a628c1b74fc03bbb59d.jpg,1,174000,174000,5.0,369
272,274802547,Tư Duy Phản Biện,9092,54200,40395,0,0,https://salt.tikicdn.com/ts/product/a4/45/88/4c15e8ceb97fd4aadadf60cad411165b.jpg,1,54200,54200,0.0,0
273,130996082,Bồ Câu Bay Đi Tìm Bà,2046,57700,40395,19300,25,https://salt.tikicdn.com/ts/product/a2/a9/e8/761bc4f440b056f6dc30aee333a51b1d.png,1,77000,77000,5.0,219
274,52785564,Dịch Hạch (Nobel Văn Chương 1957),3565,83850,40395,45150,35,https://salt.tikicdn.com/ts/product/66/a3/17/0b51ca0db5a98c5b2753c7426738d979.png,1,129000,129000,4.6,588
275,111580006,Sách Muôn Kiếp Nhân Sinh 2 (Khổ Nhỏ) - Nguyên Phong,5513,96100,40395,51900,35,https://salt.tikicdn.com/media/catalog/producttmp/63/8f/a1/71883c2b4cceec70cfff883a601059b0.jpg,1,148000,148000,5.0,1087
276,22881852,English Grammar in Use Book w Ans,12160,162400,51001,35600,18,https://salt.tikicdn.com/ts/product/b4/20/a5/cf7a92cb0f29d300e03cc24da92f1a2b.jpg,1,198000,198000,5.0,2609
277,195357772,Máy Tính CASIO FX-880BTG - Màu Đen,790,698000,40395,102000,13,https://salt.tikicdn.com/ts/product/9c/75/37/4ed95c03003bc04d8997fc064bd65cf5.png,1,800000,800000,5.0,194
278,11371249,Chuyện Con Mèo Và Con Chuột Bạn Thân Của Nó - Tái Bản,7748,27400,40395,11600,30,https://salt.tikicdn.com/ts/product/f0/fe/12/eb9b2b5567e8470cad4a8bd3d52882af.png,1,39000,39000,5.0,701
279,52805060,Chúa Ruồi - Tiểu Thuyết (Nobel Văn Chương 1983)(Tái Bản 2020),5057,65900,40395,22100,25,https://salt.tikicdn.com/ts/product/63/07/4f/086c22357912c139a4d44ec5a2a29828.jpg,1,88000,88000,4.8,870
280,147988185,"Combo 2 Cuốn ""Hiểu Hết"" : How Business Works - Hiểu Hết Về Kinh Doanh + How Money Works - Hiểu Hết Về Tiền",1326,442000,40395,238000,35,https://salt.tikicdn.com/ts/product/05/d8/bb/7dcde574538ab10b9c01aa2c21a1f037.png,1,680000,680000,4.8,194
281,159004131,Semantic Error – Lỗi Logic (Tập 1),3165,182000,40395,77000,30,https://salt.tikicdn.com/ts/product/4b/78/a4/27edd2fe25159acf145bff138934b1cc.jpg,1,259000,259000,4.8,1344
282,196923452,Birdmen - Tập 7,193,29000,40395,1000,3,https://salt.tikicdn.com/ts/product/09/0e/b8/d8ed4c2c216d3fe561260f58b138aebb.png,1,30000,30000,5.0,33
283,160997378,"Giải Thích Ngữ Pháp Tiếng Anh Với Bài Tập Và Đáp Án (TB 2022) - Tác giả Mai Lan Hương, Hà Thanh Uyên",2,176000,7082,44000,20,https://salt.tikicdn.com/ts/product/71/51/63/6fc30e765b882e119504a4bb8641c607.jpg,1,220000,220000,0.0,0
284,25557704,Bãi săn người - Trinh Thám Kinh Dị,526,81000,107665,81000,50,https://salt.tikicdn.com/ts/product/f9/04/20/09d9e0cea626ecefe97473fb9e11d376.jpg,1,162000,162000,4.8,98
285,95218451,Lần Đầu Làm Mẹ - Tổng Hợp Những Kiến Thức Mới Nhất Về Mang Thai Và Sinh Nở (Tái Bản),4317,177000,40395,83000,32,https://salt.tikicdn.com/ts/product/5c/30/76/34769674092365aa7347e89097dcaf65.png,1,260000,260000,5.0,397
286,190238356,Kỷ Luật Bản Thân,2550,114000,40395,75000,40,https://salt.tikicdn.com/ts/product/79/e9/13/2dafdde86e113f9cc39ace3bec4e0e5b.jpg,1,189000,189000,4.7,178
287,66619715,Sách Vị Tu Sĩ Bán Chiếc Ferrari (Tái Bản),7860,64200,40395,33800,34,https://salt.tikicdn.com/ts/product/ac/e7/f7/4e4afb8dafd4689ec0f6a429382307ac.jpg,1,98000,98000,4.8,906
288,50751279,Vui Vẻ Không Quạu Nha - Tản Văn,33315,46800,40395,22200,32,https://salt.tikicdn.com/ts/product/9f/f9/7d/60b384ebf807dbca830833647dae9409.png,1,69000,69000,4.7,5326
289,193411736,Anh Em Nhà Motohashi - Tập 2,383,51100,40395,16900,25,https://salt.tikicdn.com/ts/product/ca/40/31/c3884d5a6b720c1d5199709ba7f8087d.png,1,68000,68000,5.0,73
290,164336673,How The Brain Works - Hiểu Hết Về Bộ Não,981,244000,40395,86000,26,https://salt.tikicdn.com/ts/product/7f/3c/83/d025206c584e371d50fa05dceef2ad6f.png,1,330000,330000,4.8,125
291,79672197,Bí Mật Của May Mắn (Khổ Nhỏ)(Tái Bản),8993,30600,40395,14400,32,https://salt.tikicdn.com/ts/product/7e/b5/bc/0fca1705aa3459638a71a6aa53348cbe.jpg,1,45000,45000,5.0,466
292,186434700,Người Bà Tài Giỏi Vùng Saga – Tập 8,2190,31300,40395,20700,40,https://salt.tikicdn.com/ts/product/45/0e/11/c344e5829b2bc523ebb099cfe548f3d2.png,1,52000,52000,4.6,248
293,57761618,Vụ Án Mạng Ở Lữ Quán Kairotei,4588,92300,40395,30700,25,https://salt.tikicdn.com/ts/product/6f/20/e2/b0d5f44f06d4a9669aa4255833a33059.jpg,1,123000,123000,4.8,845
294,157240665,Ra Bờ Suối Ngắm Hoa Kèn Hồng (Truyện Dài-Nguyễn Nhật Ánh),11399,96400,40395,48600,34,https://salt.tikicdn.com/ts/product/5b/b6/9a/c4f7eb1f11fe6db6546d0817781cef82.jpg,1,145000,145000,5.0,2087
295,85029033,Truyện Cổ Grimm (Ấn Bản Đầy Đủ Nhất Kèm 184 Minh Hoạ Của Philipp Grot Johann Và Robert Leinweber),1927,416000,40395,264000,39,https://salt.tikicdn.com/ts/product/12/12/68/0590b222c68ceac01fc40e44d7cfd0ca.jpg,1,680000,680000,4.8,536
296,162205263,Những Đồ Vật Có Linh Hồn,1639,103000,40395,46000,31,https://salt.tikicdn.com/ts/product/89/cc/cc/e71a01419c2dfff4498c5d6982ec2e6d.jpg,1,149000,149000,4.7,463
297,143186001,Chiến Thắng Con Quỷ Trong Bạn - Bí Quyết Tự Do Và Thành Công (Tái Bản),3556,109000,40395,6000,5,https://salt.tikicdn.com/ts/product/da/ed/b0/085d2a10c027fa545c6a2d263b9d5c08.jpg,1,115000,115000,4.8,346
298,187190676,Black Jack - Tập 11,1041,27100,40395,2900,10,https://salt.tikicdn.com/ts/product/16/a7/90/00aa3a448e3f47ef7c9b7020e3b12c45.jpg,1,30000,30000,5.0,130
299,1926761,Khởi Nghiệp Bán Lẻ - Bí Quyết Thành Công Và Giàu Có Bằng Những Cửa Hàng Đông Khách - Công Thức Kinh Doanh Và Quản Lý Cửa Hàng Hiệu Quả,29813,125000,2905,74000,37,https://salt.tikicdn.com/ts/product/33/56/3e/f3bc41261a2f245ce21038c82b6bcb20.png,1,199000,199000,4.8,2305
300,141333746,"Chúng Ta Học Thế Nào - How We Learn (Sự Thật Khó Tin Về Việc Học Nó Diễn Ra Khi Nào, Ở Đâu , Và Tại Sao)",1977,113000,40395,37000,25,https://salt.tikicdn.com/ts/product/22/51/86/77c90c375e75b8e8cfc23da793c627c9.png,1,150000,150000,4.8,231
301,137741275,"Ngỡ Như Lương Thiện, Hóa Ra Mềm Yếu",1603,91300,40395,33700,27,https://salt.tikicdn.com/ts/product/82/09/0d/3376644c8915cda342ffe49675470327.jpg,1,125000,125000,4.8,219
302,14053724,Sự Cứu Rỗi Của Thánh Nữ,6961,95900,40395,32100,25,https://salt.tikicdn.com/ts/product/77/67/1e/85fff8b4fdc96acb785918a5b4124850.png,1,128000,128000,4.8,742
303,70016690,Thế Giới Rộng Lớn Lòng Người Chật Hẹp (Tặng Kèm 1 Bookmark ),7023,62500,40395,29500,32,https://salt.tikicdn.com/ts/product/12/35/c6/6c038435d6cee0ae9c314bbbec25ab4a.jpg,1,92000,92000,4.8,1691
304,66067655,Trải Nghiệm Khách Hàng Xuất Sắc,10645,163000,40395,87000,35,https://salt.tikicdn.com/ts/product/3d/df/1b/7dd52cd80588b3f3a4ccf74d77cf8804.jpg,1,250000,250000,5.0,930
305,195885685,Vua Sáng Chế -  Tập 16,262,20000,40395,0,0,https://salt.tikicdn.com/ts/product/fb/50/08/4f234f2eaa7c2d03629663fdb27376d5.jpg,1,20000,20000,5.0,35
306,67271338,Sách OSHO - Trò Chuyện Với Vĩ Nhân,3449,135000,40395,63000,32,https://salt.tikicdn.com/ts/product/15/c5/59/df0de68681e6de5758da2d101c68af4a.jpg,1,198000,198000,5.0,572
307,3976835,Velma - Trinh Thám Cổ Điển Phương Tây,764,99000,107665,0,0,https://salt.tikicdn.com/ts/product/69/89/27/5f464d057b60bea870eafaa9fc867f95.jpg,1,99000,99000,4.8,140
308,196001691,Viên Tiên Sinh Luôn Không Vui - Tập 2,704,127000,40395,52000,29,https://salt.tikicdn.com/ts/product/86/e1/94/e59b734fc2888ad808d5b92c3c153a29.png,1,179000,179000,5.0,163
309,193433626,Kỹ năng tự học cho trẻ tiểu học,643,158000,40395,41000,21,https://salt.tikicdn.com/ts/product/19/d8/eb/6b35d3dcab9365356d0eff81f1dd8866.png,1,199000,199000,4.8,32
310,108501279,Viết Đi Đừng Sợ! Từ Tay Không Thành Tay Viết,2748,189000,40395,56000,23,https://salt.tikicdn.com/ts/product/5f/82/e5/5f3afeeffb3d8d59e8245bfd40b14e6d.jpg,1,245000,245000,5.0,402
311,160081250,Tăng Cường Sức Mạnh Não Bộ,921,96100,40395,23900,20,https://salt.tikicdn.com/ts/product/8b/d3/90/de21e60b9874bb1336168c304e07afee.jpg,1,120000,120000,4.8,94
312,69644752,Toàn Thư Chiêm Tinh Học Nhập Môn,4598,227000,40395,123000,35,https://salt.tikicdn.com/ts/product/30/77/f4/3d2c4d8a8282412e9deeff5ecd1a6a9a.jpg,1,350000,350000,5.0,1090
313,186286187,Nhà Lãnh Đạo Không Chức Danh,3264,67000,40395,38000,36,https://salt.tikicdn.com/ts/product/1f/56/52/8c3e81272cb6825b8a45ed7eaf2371c0.png,1,105000,105000,5.0,134
314,100931414,Cách Khen Cách Mắng Cách Phạt Con (Tái Bản),1979,48200,40395,20800,30,https://salt.tikicdn.com/ts/product/31/b2/53/7b18e23bb629901b3869ae7c5bcf349b.png,1,69000,69000,5.0,120
315,13419678,Sách Đi Tìm Lẽ Sống (Tái Bản ),21716,59700,40395,28300,32,https://salt.tikicdn.com/ts/product/16/8f/12/1535a6bb9186658ed05e70ed6b014ead.jpg,1,88000,88000,4.8,2377
316,104314401,Sách Bí Mật Của May Mắn (Khổ Lớn) (Tái Bản),5149,46100,40395,21900,32,https://salt.tikicdn.com/ts/product/59/e3/b3/f6660d3157b49211e935116cb30a19cd.jpg,1,68000,68000,4.8,519
317,195801644,Black Jack - Tập 13 (Bìa Cứng),387,122000,40395,13000,10,https://salt.tikicdn.com/ts/product/27/5a/29/2bfc6b2d33fe96fc002e5486ddcff889.jpg,1,135000,135000,5.0,46
318,184070221,Sách OSHO Hiểu - Đường Đến Tự Do,1880,115000,40395,53000,32,https://salt.tikicdn.com/ts/product/73/b4/4b/62d91edf4d4a96d35edef7cfec15274d.jpg,1,168000,168000,5.0,194
319,193988323,Sa Vào Ánh Hào Quang Của Người – Tập 2,700,82800,40395,55200,40,https://salt.tikicdn.com/ts/product/24/da/81/4e14a0883a241e099820b361d77d5495.png,1,138000,138000,4.8,219
320,49910019,Bác Sĩ Riêng Của Bé Yêu - Chào Con! Ba Mẹ Đã Sẵn Sàng (Tái Bản),6973,56000,40395,39000,41,https://salt.tikicdn.com/ts/product/3e/4e/91/8283f63c8607eb397132a6264d98a55f.png,1,95000,95000,5.0,589
321,1938915,Sự Tiếp Xúc Của Văn Hóa Việt Nam Với Pháp,99,81650,7082,27350,25,https://salt.tikicdn.com/ts/product/60/2b/53/350cf1dc306cdcab9509522a80b5f31d.jpg,1,109000,109000,4.0,12
322,52597663,Đừng Chạy Theo Số Đông - Cuốn Sách Bạn Cần Đọc Trước Khi Quá Muộn,13943,150000,40395,50000,25,https://salt.tikicdn.com/ts/product/80/f6/5d/3095fe554e85877b5c8c593a2aa03f05.jpg,1,200000,200000,4.6,1235
323,48481763,Thiên Nga Đen (Tái Bản 2020),4822,190400,40395,108600,36,https://salt.tikicdn.com/ts/product/c7/a2/3a/c9e6eaa17656191e9fdd8febea6dd87c.jpg,1,299000,299000,4.8,626
324,13624088,Nghĩ Thiện Để Cuộc Đời Và Công Việc Viên Mãn,4385,50000,40395,35000,41,https://salt.tikicdn.com/ts/product/81/39/a1/19679d24c5b1ee096aa2f08d8dec7083.jpg,1,85000,85000,5.0,260
325,45321594,Nghệ Thuật Bán Hàng Của Người Hướng Nội,3806,77350,40395,41650,35,https://salt.tikicdn.com/ts/product/7e/0b/97/97100ff7d65b0cdb049e77bdbeae77ed.jpg,1,119000,119000,4.8,402
326,100958457,Gieo Trồng Hạnh Phúc (Tái Bản),4897,62400,40395,26600,30,https://salt.tikicdn.com/ts/product/2f/c9/a5/34f6f31122bce7bccf995604a456c71d.png,1,89000,89000,5.0,352
327,168576295,Mình Phải Sống Như Biển Rộng Sông Dài,2197,65400,40395,43600,40,https://salt.tikicdn.com/ts/product/c8/98/cc/ba634d4f83099a0ebd70081123401661.jpg,1,109000,109000,5.0,331
328,145287904,Sách - Giận (Tái Bản 2021)(Cuốn sách hay của Thiền sư Thích Nhất Hạnh/ Tặng kèm Bookmark),1811,128650,9778,0,0,https://salt.tikicdn.com/ts/product/da/8c/a5/9c61d93b6d2c6420169e0e1eb84104d1.jpg,1,128650,128650,5.0,140
329,184774173,Những Người Nhật Tử Tế,1259,104000,40395,44000,30,https://salt.tikicdn.com/ts/product/db/67/4b/3518d924ba2ccd7381ce75d6f88a7ac7.png,1,148000,148000,5.0,180
330,155683832,túi đựng card visit - JL,615,5000,60245,0,0,https://salt.tikicdn.com/ts/product/b7/68/b5/caf054114cfc38a9c57fc210b833e2f6.JPG,1,5000,5000,3.0,2
331,129381090,Minh Triết Trong Đời Sống (Tái Bản),1745,72000,40395,36000,33,https://salt.tikicdn.com/ts/product/bf/b0/5e/ab377999a08175f3c486e723b5f6191b.jpg,1,108000,108000,5.0,200
332,50723822,Con Đường Đi Đến Thành Công Bằng Sự Tử Tế (Tái Bản 2020),4801,55900,40395,14100,20,https://salt.tikicdn.com/ts/product/30/10/c7/ba3ee61619403fd121d777f19296d7e6.png,1,70000,70000,4.8,284
333,90469338,Combo 5 cuốn: Cơ Thể Tự Chữa Lành,2410,664000,40395,259000,28,https://salt.tikicdn.com/ts/product/bc/cd/07/9b7f3fc8e7d808ca4848acbc6791fb2a.jpeg,1,923000,923000,5.0,425
334,145288031,Tarot Toàn Thư - Đọc Vận Mệnh Qua Những Lá Bài,1491,247000,40395,133000,35,https://salt.tikicdn.com/ts/product/bb/44/77/13931a0a6cd8d32eabb2239fe979534c.jpg,1,380000,380000,5.0,328
335,17719702,Một Thế Giới Không Có Đàn Bà (Trinh Thám Việt Nam),104,94100,40395,47900,34,https://salt.tikicdn.com/media/catalog/producttmp/7d/b3/57/f6b10b2f37a7195102befc90702d7632.jpg,1,142000,142000,4.5,14
336,119694726,Combo 6 cuốn Ehon Kích thích thị giác - Âm thanh cho Trẻ sơ sinh,1940,121680,108120,112320,48,https://salt.tikicdn.com/ts/product/44/37/b9/52f02407537859cfb87bb574716ec7ba.jpg,1,234000,234000,5.0,312
337,197634201,Suy Nghĩ Thống Kê Trong Đời Thường,59,128000,157,0,0,https://salt.tikicdn.com/ts/product/6e/d4/c0/9f99f2b094323b99f434bf4b0bc42201.jpg,1,128000,128000,5.0,5
338,113540576,Hảo Nữ Trung Hoa,3164,83200,40395,44800,35,https://salt.tikicdn.com/ts/product/53/19/a5/0f6281e8fec4f6458bb81d118bbdef93.jpg,1,128000,128000,5.0,666
339,136143567,Thần Số Học,2634,142000,40395,77000,35,https://salt.tikicdn.com/ts/product/20/db/fb/db34b82af47599229c730a4a76f15b22.jpg,1,219000,219000,4.8,299
340,160759005,Cơ Thể Tự Chữa Lành - Thanh Lọc Để Phục Hồi,2633,177000,40395,118000,40,https://salt.tikicdn.com/ts/product/c2/8a/9c/a0afe9f442613a0dbe28bad76e7d6d92.jpg,1,295000,295000,5.0,320
341,143172597,2000 English Collocation and Idioms,2261,119000,162100,81000,41,https://salt.tikicdn.com/ts/product/d7/4a/b6/acc396dfa7dbd61bb854fd4ebe2d701b.jpg,1,200000,200000,4.8,547
342,32155084,Combo 25 Chuyên đề ngữ pháp tiếng anh trọng tâm ( trọn bộ tập 1+2 ),8725,170000,40395,60000,26,https://salt.tikicdn.com/ts/product/b3/ed/45/612eb3a86e93d5ebad6ba8004914ca38.jpg,1,230000,230000,5.0,2607
343,179063564,Tôi Tự Học,2811,78000,40395,42000,35,https://salt.tikicdn.com/ts/product/b1/1b/a0/d139eeff67b735e237a5ec5d97c8dfac.jpg,1,120000,120000,4.8,224
344,195190275,Bá Tước Tiểu Thư - Tập 2,298,30000,40395,0,0,https://salt.tikicdn.com/ts/product/8d/be/89/3b40a4f1c29b5fcc87735078970e1e95.jpg,1,30000,30000,5.0,43
345,44433397,"Yêu Mình Trước Đã, Yêu Đời Để Sau",6810,70900,40395,38100,35,https://salt.tikicdn.com/ts/product/ed/1e/6e/e7cc2a5c73f7a4206a85a66f3bfa3a09.jpg,1,109000,109000,4.8,676
346,153045603,Sách Người Giỏi Không Phải Là Người Làm Tất Cả (Tái Bản 2021),2985,41700,40395,16300,28,https://salt.tikicdn.com/ts/product/81/6b/df/3e9dba649fbb5f2a3486dec8bb211bf6.png,1,58000,58000,5.0,184
347,100931418,Giao Tiếp Bất Kỳ Ai - 101 Cách Nâng Cao Khả Năng Giao Tiếp (Tái Bản),2220,38400,40395,16600,30,https://salt.tikicdn.com/ts/product/f1/a4/63/20b0c01728bbf12dd4a99440d1a54b08.jpg,1,55000,55000,4.8,266
348,50072452,Lâu Đài Bay Của Pháp Sư Howl (Tái Bản 2020),6208,68900,40395,37100,35,https://salt.tikicdn.com/ts/product/19/57/d2/f8e8ac1e83c74d24ef57d5e1a8194be7.jpg,1,106000,106000,4.8,1389
349,176752838,Thay Đổi Tí Hon Hiệu Quả Bất Ngờ - Atomic Habits,1419,160000,7082,29000,15,https://salt.tikicdn.com/ts/product/c2/77/6d/b22a78f910ff68e5bcb7f42a2fce9ba2.png,1,189000,189000,5.0,124
350,198016656,Blue Flag - Tập 3,404,42800,40395,2200,5,https://salt.tikicdn.com/ts/product/3d/98/a8/c8ba4a289cb1ba60115fa4c64beb10f3.png,1,45000,45000,5.0,75
351,148802202,How Philosophy Works - Hiểu Hết Về Triết Học,1157,247000,40395,83000,25,https://salt.tikicdn.com/ts/product/7d/11/26/2fefb836de225d69b61cb8618e4151c9.jpg,1,330000,330000,4.8,178
352,54051752,Bộ Ba Quái Hiệp (Trinh Thám),501,69000,107665,69000,50,https://salt.tikicdn.com/ts/product/ae/62/f4/ea7aaf92e98312f6265ab1f7e89a7edd.jpg,1,138000,138000,4.8,101
353,160081252,Người Tan Làm Sau Cùng Là Người Nghỉ Việc Đầu Tiên (Tặng kèm bookmark),1630,84400,40395,34600,29,https://salt.tikicdn.com/ts/product/84/fa/2e/4c4b22071f28329c97a765d7ee02e241.jpg,1,119000,119000,4.7,219
354,197634252,Văn phòng thám tử quái vật - Tập 13,485,26300,40395,3700,12,https://salt.tikicdn.com/ts/product/44/92/6d/73eb8975eb19c4456557005f8dc77517.png,1,30000,30000,5.0,84
355,96357336,Cáo Pax,2029,86900,40395,29100,25,https://salt.tikicdn.com/ts/product/2b/72/c2/853de3a3dcc7adeb4156c507e3c69747.png,1,116000,116000,5.0,347
356,197781977,Yu-Gi-Oh! Gx Tập 1: “Người Hùng Mới” Lộ Diện,266,28400,40395,1600,5,https://salt.tikicdn.com/ts/product/68/7a/4d/4ef6caa40d380b36b7922720f9970a4d.png,1,30000,30000,4.8,39
357,182548592,Thiên Sứ Nhà Bên – Tập 3,927,71300,40395,23700,25,https://salt.tikicdn.com/ts/product/6c/a9/29/4ae5042fc258b9df1e1461f466dc0b04.png,1,95000,95000,5.0,325
358,1080002,Boxset Harry Potter - Tiếng Việt (Trọn Bộ 7 Tập),10172,1019000,40395,731000,42,https://salt.tikicdn.com/ts/product/28/52/39/98767249ca530720557913823b5a5696.jpg,1,1750000,1750000,4.7,1526
359,48323805,Sách Người trong muôn nghề,5706,170100,10614,18900,10,https://salt.tikicdn.com/ts/product/b0/cd/45/39ec10f4d7441d685cc8be56e453c862.png,1,189000,189000,4.8,826
360,100947274,Tìm Bình Yên Trong Gia Đình (Tái Bản),2372,69200,40395,29800,30,https://salt.tikicdn.com/ts/product/cf/c0/1f/f6dacfe2f8e1ae59f832bd69fc0769d0.png,1,99000,99000,5.0,186
361,243358535,Squid Game Móc khoá - Móc khoá Silicon 5cm-SQ1,1641,20000,933,0,0,https://salt.tikicdn.com/ts/product/4a/ab/b6/d1342b9ee3c6b4ad96f3d39e571a668c.jpg,1,20000,20000,4.3,4
362,179952621,Hành Trình Tarot (Tái Bản 2022),1171,115000,40395,34000,23,https://salt.tikicdn.com/ts/product/c7/dc/31/1b5a0f03ced98dbbd4748b04a847aecb.png,1,149000,149000,5.0,195
363,196944533,Tài chính doanh nghiệp for Dummies,680,162520,40395,76480,32,https://salt.tikicdn.com/ts/product/04/40/23/52a1b6fe66c344ab6deae0a195f30114.jpg,1,239000,239000,4.8,55
364,90056907,Khởi Nghiệp Tinh Gọn (The Lean Startup) (Tái Bản),4082,130000,40395,35000,21,https://salt.tikicdn.com/ts/product/fd/af/df/8df7b7af362288e0a5e8618bd1d5261a.jpg,1,165000,165000,5.0,549
365,626886,Những Tấm Lòng Cao Cả,10241,53500,40395,26500,33,https://salt.tikicdn.com/ts/product/9e/5e/d9/7215751b7bd589b890001500d79da00a.jpg,1,80000,80000,5.0,955
366,186091870,Fullmetal Alchemist - Cang Giả Kim Thuật Sư - Fullmetal Edition Tập 15 [Tặng Kèm Bookmark PVC],796,65500,40395,3500,5,https://salt.tikicdn.com/ts/product/83/ce/44/6368388bd049173b00d384418392d3a1.jpg,1,69000,69000,5.0,99
367,171057415,Cẩm nang hướng dẫn tự học tiếng Thái – trình độ sơ cấp – trung cấp,1,98000,157,0,0,https://salt.tikicdn.com/ts/product/13/d0/c0/0e0b25d3cb32f06110804b08e1fcb176.jpg,1,98000,98000,0.0,0
368,81323246,90-20-30 90 Bài Học Vỡ Lòng Về Ý Tưởng Và Câu Chữ (Bản Đen Trắng),7428,156000,40395,39000,20,https://salt.tikicdn.com/ts/product/85/06/ce/fdb7c60c39f0705e5ecd9a6f617629c4.jpg,1,195000,195000,5.0,1414
369,194104631,Mong Bạn Đừng Khóc Một Mình,342,63300,40395,24700,28,https://salt.tikicdn.com/ts/product/a5/0a/ba/4d9eeb81807afb6649aa87516df272aa.jpg,1,88000,88000,5.0,34
370,80657321,Cơ Thể Tự Chữa Lành: Phục Hồi Tuyến Giáp,4173,121000,40395,59000,33,https://salt.tikicdn.com/ts/product/fc/5c/15/967c438cc1ee033ca84cf51e6a91fe44.jpg,1,180000,180000,5.0,571
371,176550321,Bàn Về Ham Muốn: Tại Sao Chúng Ta Muốn Thứ Mà Ta Muốn,1779,118100,40395,50900,30,https://salt.tikicdn.com/ts/product/22/cd/a3/fca6a4a14c33ef8b5029cd71bf17b93d.jpg,1,169000,169000,5.0,197
372,57870426,Sức Mạnh Của Ngôn Từ (Tặng Kèm 1 Photocard Mintbooks Limited),13894,67100,40395,28900,30,https://salt.tikicdn.com/ts/product/04/fa/2c/76e53ee08e9832a7068d004a937fd397.jpg,1,96000,96000,4.8,3176
373,161245852,Giải Thích Ngữ Pháp Tiếng Anh (Tái Bản 2022),1211,165000,51001,55000,25,https://salt.tikicdn.com/ts/product/36/80/e0/fd077176313b62c62a2c88bf34349056.jpg,1,220000,220000,5.0,211
374,187622420,The Art and Science of Technical Analysis – Phân tích kỹ thuật: Sự kết hợp giữa KHOA HỌC và NGHỆ THUẬT trong đầu tư chứng khoán,408,569000,7269,0,0,https://salt.tikicdn.com/ts/product/d9/c0/9d/dc7a682cb19c58a31f9d3dd085ebe4ad.png,1,569000,569000,4.8,61
375,3737963,Bức Xúc Không Làm Ta Vô Can (Tái Bản),11528,63800,40395,21200,25,https://salt.tikicdn.com/ts/product/ab/13/8a/7c60748465b9fe8ba6049fd6a4f4cc00.png,1,85000,85000,4.8,1040
376,195649281,Đọc Vị Tâm Lý Hành Vi Của Giới Giàu Và Siêu Giàu,202,193400,40395,105600,35,https://salt.tikicdn.com/ts/product/2f/9e/bf/98f744332d20c3686f2d49f20e1ab5a7.jpg,1,299000,299000,4.6,17
377,115478654,"Keo Siêu Dính Đa Năng Mạnh Gấp 80 Keo 502 Dán Sắt, Dán Đá, Dán Nhựa, Dán Gỗ",901,39000,130911,0,0,https://salt.tikicdn.com/ts/product/45/bc/a6/0d2c0254fad0b8cd3f86ce289e3572e4.jpg,1,39000,39000,4.6,95
378,194104232,Anh Em Phi Hành Gia - Tập 32,308,40500,40395,4500,10,https://salt.tikicdn.com/ts/product/86/1c/fc/77577efc847655c67c529104598a0006.png,1,45000,45000,5.0,33
379,191148794,Tôi Ước Mình Chưa Từng Được Sinh Ra -Tặng kèm 1 bookmark,869,62000,40395,28000,31,https://salt.tikicdn.com/ts/product/88/49/fe/1ffc4cd77acad513f960fd927e886c70.jpg,1,90000,90000,4.8,143
380,178483637,Nước Ép Trị Liệu Và Chế Độ Ăn Theo Phương Pháp Cơ Thể Tự Chữa Lành,3196,131340,40395,67660,34,https://salt.tikicdn.com/ts/product/fc/db/81/3163317968b5b9e332ab61c2b275bddd.png,1,199000,199000,5.0,301
381,147058065,Phi Lý Trí - Khám Phá Những Động Lực Vô Hình Ẩn Sau Những Quyết Định Của Con Người ( Tái Bản),2028,112020,40395,56980,34,https://salt.tikicdn.com/ts/product/26/63/01/8f63e7dcd811725003510315aafb0fa3.jpg,1,169000,169000,4.8,214
382,113655533,Giáo Trình Chủ Nghĩa Xã Hội Khoa Học (Dành Cho Bậc Đại Học Hệ Không Chuyên Lý Luận Chính Trị) - Bộ mới năm 2021,2163,58000,157,0,0,https://salt.tikicdn.com/ts/product/c3/3d/4d/b5bc6d2457d45d46045b0d46c48fbbae.jpg,1,58000,58000,5.0,368
383,125528587,"Thần Với Chả Thoại (Những Câu Chuyện ""Mệt Mỏi"" Về Các Vị Thần)",1307,85000,40395,54000,39,https://salt.tikicdn.com/ts/product/8f/c1/45/201ed3039e264343adb298b0c566251f.jpg,1,139000,139000,4.8,234
384,193433863,101 Lời Khuyên Tài Chính Cá Nhân Từ Thái Phạm,687,299000,7269,0,0,https://salt.tikicdn.com/ts/product/d5/a2/d7/709477fc8be9abf67ab75b3f682ca67f.png,1,299000,299000,5.0,90
385,110448020,Nhà Ảo Thuật Đen Và Vụ Án Mạng Tại Thị Trấn Không Tên,2550,150000,40395,49000,25,https://salt.tikicdn.com/ts/product/2b/a9/3c/a64e231c5991f2b24a4e84dc8a09e859.jpg,1,199000,199000,4.8,553
386,87959748,451 Độ F,2437,76100,40395,22900,23,https://salt.tikicdn.com/ts/product/68/ee/44/8c15305e460c77c7010e786c8f4f14c6.jpg,1,99000,99000,4.8,464
387,193434488,Kingdom -  Tập 32,420,42700,40395,2300,5,https://salt.tikicdn.com/ts/product/c9/b9/40/4e09cab75de7ade15f41289511890147.jpg,1,45000,45000,5.0,43
388,162181800,Cảm Ơn Anh Đã Đánh Mất Em,3843,54500,40395,44500,45,https://salt.tikicdn.com/ts/product/e0/83/9e/f9b17a5ce63d92c59c95bac6dc1ae4b8.jpg,1,99000,99000,5.0,517
389,58695343,Kỹ Năng Giao Tiếp Đỉnh Cao,3769,62300,40395,33700,35,https://salt.tikicdn.com/ts/product/0e/0c/6a/8877ceefe6bc962af4a305626c7db059.jpg,1,96000,96000,4.8,505
